entity	type	rank_sampling	rank_passive	rank_diff	upgrade_score
Division_No._11,_Alberta	wordnet_administrative_district_108491826	16329	1	16328	16328.0
Gmina_Tarnawatka	wordnet_administrative_district_108491826	4982	1	4981	4981.0
Fluminense_F.C.	wikicat_Football_clubs_in_Rio_de_Janeiro_(city)	4027	5	4022	804.4
Orange_County_(Florida)	wordnet_county_108546183	696	1	695	695.0
Unión_Española	wordnet_club_108227214	384	1	383	383.0
SC_Heerenveen	wordnet_club_108227214	331	2	329	164.5
Herfølge_Boldklub	wikicat_Football_clubs_in_Denmark	308	2	306	153.0
Otago	wordnet_administrative_district_108491826	14439	119	14320	120.33613445378151
Boxer_Rebellion	wordnet_conflict_100958896	121	1	120	120.0
Confederation_of_the_Rhine	wordnet_country_108544813	227	2	225	112.5
Cienciano	wordnet_club_108227214	224	2	222	111.0
Adanaspor	wordnet_club_108227214	99	1	98	98.0
Ronald_Arana	wikicat_Club_Bolívar_players	5268	55	5213	94.78181818181818
Mersin_İdmanyurdu_SK	wikicat_Football_clubs_in_Turkey	4750	50	4700	94.0
Oxford,_Ohio	wikicat_Cities_in_Ohio	84	1	83	83.0
Damián_Manso	wikicat_Monarcas_Morelia_footballers	406	5	401	80.2
F.C._Arouca	wikicat_Football_clubs_in_Portugal	641	8	633	79.125
Dungannon_Swifts_F.C.	wikicat_Association_football_clubs_established_in_1949	3544	50	3494	69.88
Videoton_FC	wikicat_Football_clubs_in_Hungary	11530	172	11358	66.03488372093024
SC_Telstar	wikicat_Association_football_clubs_established_in_1963	15054	225	14829	65.90666666666667
Settling_Accounts	wordnet_conflict_100958896	133	2	131	65.5
III._Kerületi_TUE	wikicat_Association_football_clubs_established_in_1887	8446	134	8312	62.02985074626866
Wycombe_Wanderers_F.C.	wikicat_Fan-owned_English_League_football_clubs	45	1	44	44.0
Singapore	wikicat_Port_cities	16984	378	16606	43.93121693121693
Sétif_Province	wordnet_administrative_district_108491826	1899	44	1855	42.15909090909091
Keeneland	wordnet_racetrack_104037625	129	3	126	42.0
Clube_Atlético_Juventus	wordnet_club_108227214	205	5	200	40.0
Ilkeston_F.C.	wikicat_Southern_Football_League_clubs	39	1	38	38.0
Norm_Macdonald	wikicat_Living_people	36	1	35	35.0
Robert_I,_Duke_of_Parma	wordnet_sovereign_110628644	36	1	35	35.0
Dave_Norton	wikicat_Notts_County_F.C._players	139	4	135	33.75
Bonn	wikicat_Former_national_capitals	2208	65	2143	32.96923076923077
Bradley_Thomas_(footballer)	wikicat_Weymouth_F.C._players	167	5	162	32.4
Regional_Municipality_of_Peel	wordnet_administrative_district_108491826	166	5	161	32.2
Aleutians_East_Borough,_Alaska	wordnet_county_108546183	166	5	161	32.2
Werder_Bremen	wordnet_club_108227214	66	2	64	32.0
Rome,_New_York	wordnet_administrative_district_108491826	32	1	31	31.0
San_Antonio	wikicat_Cities_in_Texas	31	1	30	30.0
Club_Blooming	wikicat_Football_clubs_in_Bolivia	5564	185	5379	29.075675675675676
George_Dantzig	wikicat_American_computer_scientists	925	31	894	28.838709677419356
Jair_Baylón	wikicat_Expatriate_footballers_in_Uruguay	298	10	288	28.8
Zhuhai_Jinwan_Airport	wikicat_Airports_in_Guangdong	89	3	86	28.666666666666668
Putrajaya	wikicat_Capitals_in_Asia	29	1	28	28.0
Randers_FC	wordnet_club_108227214	58	2	56	28.0
Tim_Berners-Lee	wikicat_Internet_pioneers	1801	66	1735	26.28787878787879
NK_Neretva	wikicat_Football_clubs_in_Croatia	132	5	127	25.4
Roger_Ebert	wordnet_writer_110794014	26	1	25	25.0
Raleigh–Durham_International_Airport	wikicat_Airfields_of_the_United_States_Army_Air_Forces_Technical_Service_Command	51	2	49	24.5
Nobel_Prize_in_Literature	wikicat_Swedish_awards	301	12	289	24.083333333333332
Ben_Sahar	wikicat_Israeli_footballers	50	2	48	24.0
Le_Havre_AC	wikicat_Football_clubs_in_France	1025	41	984	24.0
Sultan_Syarif_Kasim_II_International_Airport	wordnet_airport_102692232	25	1	24	24.0
Adalto_Batista_da_Silva	wikicat_Guarani_Futebol_Clube_players	25	1	24	24.0
The_Dirty_Dozen	wikicat_Films_based_on_novels	95	4	91	22.75
SFC_Opava	wikicat_Association_football_clubs_established_in_1907	1633	69	1564	22.666666666666668
Tayt_Ianni	wikicat_United_States_men's_international_soccer_players	46	2	44	22.0
VVV-Venlo	wikicat_Football_clubs_in_the_Netherlands	1649	72	1577	21.90277777777778
Reggie_Davani	wikicat_Expatriate_soccer_players_in_Australia	1397	62	1335	21.532258064516128
Reykjavík	wikicat_Port_cities	381	17	364	21.41176470588235
Howard_Shore	wikicat_Living_people	42	2	40	20.0
Iberian_Peninsula	wikicat_Regions_of_Europe	428	21	407	19.38095238095238
ND_Gorica	wikicat_Football_clubs_in_Slovenia	40	2	38	19.0
Porto-Novo	wikicat_Capitals	40	2	38	19.0
Videoton_FC	wordnet_club_108227214	1867	95	1772	18.652631578947368
Torquay_United_F.C.	wikicat_Association_football_clubs_established_in_1899	333	17	316	18.58823529411765
Alappuzha	wikicat_Cities_and_towns_in_Kerala	39	2	37	18.5
Giuliano_Amato	wikicat_Living_people	39	2	37	18.5
Arne_Friedrich	wikicat_German_expatriate_footballers	58	3	55	18.333333333333332
Paulo_Marcel_Pereira_Merabet	wikicat_K.S.C._Lokeren_Oost-Vlaanderen_players	38	2	36	18.0
Ronald_Arana	wikicat_Expatriate_footballers_in_Argentina	19	1	18	18.0
Richard_Feynman	wikicat_Jewish_American_scientists	19	1	18	18.0
Thelma_Schoonmaker	wikicat_Living_people	38	2	36	18.0
A.F.C._Bournemouth	wordnet_club_108227214	18	1	17	17.0
Nikita_Rukavytsya	wikicat_2._Bundesliga_players	72	4	68	17.0
Legazpi,_Albay	wordnet_administrative_district_108491826	18	1	17	17.0
Preston_North_End_F.C.	wikicat_Publicly_traded_sports_companies	349	20	329	16.45
Václav_Klaus	wikicat_Living_people	418	24	394	16.416666666666668
Le_Havre_A.C.	wordnet_club_108227214	657	38	619	16.289473684210527
De_Graafschap	wordnet_club_108227214	69	4	65	16.25
Second_Crusade	wordnet_conflict_100958896	2925	170	2755	16.205882352941178
Oscar_Dertycia	wikicat_Talleres_footballers	117	7	110	15.714285714285714
Godsmack	wikicat_Musical_groups_established_in_1996	1069	66	1003	15.196969696969697
Anambra_State	wordnet_administrative_district_108491826	16	1	15	15.0
Yale_School_of_Drama	wikicat_Drama_schools_in_the_United_States	432	27	405	15.0
Jeonnam_Dragons	wikicat_K_League_Classic_clubs	814	52	762	14.653846153846153
Manchester_United_F.C.	wikicat_G-14_clubs	46	3	43	14.333333333333334
Linlithgow_Rose_F.C.	wikicat_Association_football_clubs_established_in_1889	1148	76	1072	14.105263157894736
FC_Arsenal_Kyiv	wikicat_Association_football_clubs_established_in_1934	3397	226	3171	14.030973451327434
Charlotte_Rampling	wikicat_Living_people	15	1	14	14.0
Walter_Novellino	wikicat_A.C._Legnano_players	13000	870	12130	13.942528735632184
Abu_Dhabi	wikicat_Port_cities_in_the_Arabian_Peninsula	2658	179	2479	13.849162011173185
Club_Social_y_Deportivo_Macará	wikicat_Association_football_clubs_established_in_1939	5818	393	5425	13.804071246819339
Ninoslav_Milenković	wikicat_K._Sint-Truidense_V.V._players	3003	207	2796	13.507246376811594
Richard_Garcia	wikicat_Hull_City_A.F.C._players	57	4	53	13.25
Levan_Maghradze	wikicat_Ermis_Aradippou_players	2132	151	1981	13.119205298013245
Alaska	wikicat_States_and_territories_established_in_1959	197	14	183	13.071428571428571
Florianópolis	wikicat_State_capitals_in_Brazil	2088	149	1939	13.013422818791947
Bret_McKenzie	wikicat_21st-century_New_Zealand_male_actors	14	1	13	13.0
Strasbourg	wordnet_country_108544813	28	2	26	13.0
Drama_Desk_Award	wikicat_Theatre_awards	70	5	65	13.0
Martin_Luther_King,_Jr.	wikicat_American_humanitarians	1801	129	1672	12.96124031007752
Mali_national_football_team	wordnet_football_team_108080025	179	13	166	12.76923076923077
Australian_Capital_Territory	wordnet_administrative_district_108491826	243	18	225	12.5
Strasbourg	wikicat_Prefectures_in_France	27	2	25	12.5
Jun_Senoue	wikicat_People_from_Miyagi_Prefecture	1534	114	1420	12.456140350877194
MFK_Ružomberok	wikicat_Association_football_clubs_established_in_1906	453	34	419	12.323529411764707
Alex_Bruce_(footballer,_born_1984)	wikicat_Oldham_Athletic_A.F.C._players	92	7	85	12.142857142857142
Red_Sea	wikicat_Biblical_places	2712	207	2505	12.101449275362318
Ribeirão_Preto	wordnet_administrative_district_108491826	13	1	12	12.0
Bogotá	wikicat_Capitals_in_South_America	52	4	48	12.0
Iván_Guerrero	wikicat_Colorado_Rapids_players	13	1	12	12.0
Aşgabat_FT	wordnet_club_108227214	13	1	12	12.0
MFC_Kremin_Kremenchuk	wikicat_Association_football_clubs_established_in_1959	305	24	281	11.708333333333334
PBC_Lokomotiv-Kuban	wikicat_Sports_clubs_established_in_1946	1545	123	1422	11.560975609756097
Delron_Buckley	wikicat_Borussia_Dortmund_II_players	2459	197	2262	11.48223350253807
Georg_Wilhelm_Friedrich_Hegel	wikicat_German_logicians	49	4	45	11.25
Kazuyuki_Toda	wikicat_Expatriate_footballers_in_England	48	4	44	11.0
Rochester,_New_York	wordnet_administrative_district_108491826	12	1	11	11.0
André_Guerreiro_Rocha	wikicat_Expatriate_footballers_in_Greece	12	1	11	11.0
Tunis	wikicat_Capitals_in_Africa	12	1	11	11.0
Puerto_Cabello	wikicat_Port_cities	12	1	11	11.0
Gmina_Szelków	wordnet_administrative_district_108491826	538	47	491	10.446808510638299
Kalusha_Bwalya	wikicat_Club_Necaxa_footballers	68	6	62	10.333333333333334
Paraná_Clube	wordnet_club_108227214	11	1	10	10.0
Pyongyang	wikicat_Capitals_in_Asia	22	2	20	10.0
Robert_Rich_(musician)	wikicat_Electronic_musicians	22	2	20	10.0
Alicante_CF	wikicat_Football_clubs_in_Spain	11	1	10	10.0
RCD_Mallorca	wikicat_Organisations_based_in_Spain_with_royal_patronage	11	1	10	10.0
Ilya_Maksimov	wikicat_FC_Shinnik_Yaroslavl_players	76	7	69	9.857142857142858
Gimnástica_de_Torrelavega	wikicat_Association_football_clubs_established_in_1907	464	43	421	9.790697674418604
Manchester_United_F.C.	wikicat_Association_football_clubs_established_in_1878	43	4	39	9.75
FC_Pyunik	wikicat_Association_football_clubs_established_in_1996	32	3	29	9.666666666666666
Zlatko_Yankov	wikicat_1994_FIFA_World_Cup_players	32	3	29	9.666666666666666
Royal_Tunbridge_Wells	wikicat_Towns_in_Kent	42	4	38	9.5
Dai_Nagao	wordnet_artist_109812338	21	2	19	9.5
Piarco_International_Airport	wikicat_Airfields_of_the_United_States_Army_Air_Forces	292	28	264	9.428571428571429
Karachi	wikicat_Capitals_of_Pakistan	31	3	28	9.333333333333334
Gençlerbirliği_S.K.	wordnet_club_108227214	10	1	9	9.0
FC_Andorra	wikicat_Football_clubs_in_Spain	10	1	9	9.0
Brasília	wikicat_States_of_Brazil	40	4	36	9.0
T._S._Eliot	wikicat_Wesleyan_University_people	1118	112	1006	8.982142857142858
Isidor_Isaac_Rabi	wikicat_Jewish_American_scientists	68	7	61	8.714285714285714
Sydney_Brenner	wikicat_Biologists	184	19	165	8.68421052631579
Sebastian_Helbig	wikicat_Bayer_04_Leverkusen_players	29	3	26	8.666666666666666
Susan_Sontag	wikicat_21st-century_American_writers	29	3	26	8.666666666666666
Wellington_da_Silva_Serezuella	wikicat_Associação_Ferroviária_de_Esportes_players	1270	132	1138	8.621212121212121
Leonid_Hurwicz	wordnet_person_100007846	115	12	103	8.583333333333334
Zeeland	wikicat_States_of_the_Holy_Roman_Empire	19	2	17	8.5
FC_Stal_Alchevsk	wikicat_Football_clubs_in_Ukraine	19	2	17	8.5
Inter_Baku_PIK	wikicat_Association_football_clubs_established_in_1997	171	18	153	8.5
Thomas_Jefferson	wikicat_Protestant_philosophers	3652	386	3266	8.461139896373057
Bucholz_Army_Airfield	wordnet_airport_102692232	28	3	25	8.333333333333334
José_Augusto_Freitas_Sousa	wikicat_Bangu_Atlético_Clube_players	261	28	233	8.321428571428571
Ronald_Fisher	wikicat_British_astronomers	65	7	58	8.285714285714286
Aria_(film)	wikicat_Miramax_Films_films	102	11	91	8.272727272727273
Vladislav_Stoyanov	wikicat_Expatriate_footballers_in_Moldova	3016	327	2689	8.223241590214068
Leonid_Hurwicz	wikicat_Jewish_American_scientists	110	12	98	8.166666666666666
Anchorage,_Alaska	wikicat_Alaska_boroughs	679	75	604	8.053333333333333
Daigo_Kobayashi	wikicat_Norwegian_Premier_League_players	18	2	16	8.0
Southampton	wikicat_Port_cities	9	1	8	8.0
Uvalde,_Texas	wikicat_Cities_in_Texas	9	1	8	8.0
Flamurtari_Vlorë	wordnet_club_108227214	9	1	8	8.0
FC_Atyrau	wordnet_club_108227214	9	1	8	8.0
FC_Dnepr_Mogilev	wordnet_club_108227214	9	1	8	8.0
Mark_Fotheringham	wikicat_Scottish_expatriate_footballers	107	12	95	7.916666666666667
Southeast_Asia	wikicat_Regions_of_Asia	294	34	260	7.647058823529412
Danny_Higginbotham	wikicat_English_expatriate_footballers	69	8	61	7.625
F.C._Dynamo_Kyiv	wordnet_club_108227214	43	5	38	7.6
Scania	wikicat_Regions_of_Europe	2018	235	1783	7.587234042553192
James_Ivory_(director)	wikicat_American_people_of_Irish_descent	60	7	53	7.571428571428571
C.R._Vasco_da_Gama	wikicat_Association_football_clubs_established_in_1898	454	53	401	7.566037735849057
Dave_Mitchell_(footballer)	wikicat_Australian_expatriates_in_Turkey	17	2	15	7.5
Wales	wikicat_Island_countries	17	2	15	7.5
Precious_Emuejeraye	wikicat_Expatriate_footballers_in_Indonesia	68	8	60	7.5
Ivor_Novello_Awards	wordnet_award_106696483	186	22	164	7.454545454545454
Portland,_Oregon	wikicat_Populated_places_on_the_Columbia_River	650	77	573	7.441558441558442
Leandro_Lourenço_Franco	wikicat_Sport_Boys_footballers	669	80	589	7.3625
Jean_Michel_Jarre	wikicat_French_composers	25	3	22	7.333333333333333
Bytów_County	wordnet_administrative_district_108491826	100	12	88	7.333333333333333
Haruki_Murakami	wikicat_20th-century_novelists	50	6	44	7.333333333333333
Germán_Herrera	wikicat_Campeonato_Brasileiro_Série_A_footballers	58	7	51	7.285714285714286
Tunis	wikicat_Capitals	404	49	355	7.244897959183674
Club_Atlético_Sarmiento	wordnet_club_108227214	7499	910	6589	7.240659340659341
Gina_Lollobrigida	wikicat_Italian_women	41	5	36	7.2
Deluge_(history)	wikicat_Wars_involving_Sweden	49	6	43	7.166666666666667
Gimnàstic_de_Tarragona	wikicat_Football_clubs_in_Spain	8672	1071	7601	7.097105508870214
Los_Angeles_International_Airport	wordnet_airport_102692232	8	1	7	7.0
Deportivo_Quito	wordnet_club_108227214	8	1	7	7.0
Maputo	wikicat_Port_cities_in_Africa	24	3	21	7.0
Dario_Dabac	wikicat_Sanfrecce_Hiroshima_players	8	1	7	7.0
Saunders_Mac_Lane	wikicat_American_people	8	1	7	7.0
Wu-Tang_Clan	wordnet_artist_109812338	8	1	7	7.0
Aleksandar_Trišović	wikicat_FC_Metalist_Kharkiv_players	16	2	14	7.0
Mato_Neretljak	wikicat_K_League_players	16	2	14	7.0
Steve_Bowey	wikicat_Bristol_Rovers_F.C._players	16	2	14	7.0
Popular_Republican_Movement	wikicat_Catholic_political_parties	47	6	41	6.833333333333333
Alekos_Alekou	wikicat_Expatriate_footballers_in_Hungary	70	9	61	6.777777777777778
Huddersfield_Town_F.C.	wikicat_Association_football_clubs_established_in_1908	70	9	61	6.777777777777778
Eduardo_Gonçalves_de_Oliveira	wikicat_Brazil_international_footballers	101	13	88	6.769230769230769
Portuguese_Empire	wikicat_Overseas_empires	115	15	100	6.666666666666667
Tiro_Federal	wordnet_club_108227214	2432	319	2113	6.623824451410658
Pascal_Zuberbühler	wikicat_Bayer_04_Leverkusen_players	2450	325	2125	6.538461538461538
Warriors_F.C.	wikicat_Association_football_clubs_established_in_1975	45	6	39	6.5
Mitrovica,_Kosovo	wordnet_administrative_district_108491826	15	2	13	6.5
Jack_Cork	wikicat_Association_football_defenders	30	4	26	6.5
Bolton_Wanderers_F.C.	wikicat_Association_football_clubs_established_in_1874	359	48	311	6.479166666666667
Deportivo_Cuenca	wikicat_Association_football_clubs_established_in_1971	88	12	76	6.333333333333333
Ronald_Fisher	wikicat_English_mathematicians	88	12	76	6.333333333333333
S.S._Lazio	wikicat_Multi-sport_clubs	110	15	95	6.333333333333333
Ricardo_Montalbán	wikicat_American_film_directors	95	13	82	6.3076923076923075
The_Bronx	wikicat_Populated_places_established_in_1639	1659	228	1431	6.276315789473684
Hanoi	wikicat_Populated_places_established_in_the_11th_century	5218	718	4500	6.2674094707520895
Eleftheria_Arvanitaki	wikicat_Singers	138	19	119	6.2631578947368425
Danny_Graham_(footballer)	wikicat_Blackpool_F.C._players	29	4	25	6.25
Adap_Galo_Maringá_Football_Club	wikicat_Association_football_clubs_established_in_2006	10070	1391	8679	6.239396117900791
Luke_Corbett	wikicat_Association_football_forwards	57	8	49	6.125
Godfrey_Ingram	wikicat_Major_Indoor_Soccer_League_(1978–92)_players	57	8	49	6.125
Le_streghe	wikicat_Comedy-drama_films	169	24	145	6.041666666666667
Honolulu	wikicat_Port_cities	7	1	6	6.0
Williams_Martínez	wikicat_Expatriate_footballers_in_France	7	1	6	6.0
Borussia_Dortmund	wordnet_club_108227214	7	1	6	6.0
Maksym_Levytskyi	wikicat_Ligue_1_players	7	1	6	6.0
Holy_Roman_Empire	wordnet_country_108544813	7	1	6	6.0
American_Revolutionary_War	wikicat_Wars_involving_France	7	1	6	6.0
Nelson_Mandela	wikicat_Marxist_writers	1009	145	864	5.958620689655173
Battle_of_Leipzig	wikicat_Conflicts_in_1813	465	67	398	5.940298507462686
Francisco_Ferreira_(Paraguayan_footballer)	wikicat_Oriente_Petrolero_players	111	16	95	5.9375
Borough_of_Milton_Keynes	wordnet_county_108546183	11932	1722	10210	5.929152148664344
Alphonse_Tchami	wikicat_1994_FIFA_World_Cup_players	76	11	65	5.909090909090909
Vesa-Matti_Loiri	wikicat_Finnish_people	1893	275	1618	5.883636363636364
Steve_Jones_(Northern_Irish_footballer)	wikicat_Northern_Premier_League_players	48	7	41	5.857142857142857
Millonarios_Fútbol_Club	wikicat_Categoría_Primera_A_clubs	1278	187	1091	5.834224598930481
Keanu_Reeves	wikicat_American_television_actors	82	12	70	5.833333333333333
Alex_Nyarko	wikicat_Footballers_at_the_1992_Summer_Olympics	1398	205	1193	5.819512195121951
Rijeka_Airport	wordnet_airport_102692232	27	4	23	5.75
Emsland	wordnet_district_108552138	133	20	113	5.65
Republican_Party_(United_States)	wikicat_International_Democrat_Union_member_parties	13	2	11	5.5
FC_Steaua_București	wordnet_club_108227214	13	2	11	5.5
Zoran_Milinković_(footballer)	wikicat_FK_Vojvodina_players	13	2	11	5.5
Subrahmanyan_Chandrasekhar	wikicat_American_people	26	4	22	5.5
Gustav_Kirchhoff	wikicat_Ethnic_German_people	13	2	11	5.5
New_Delhi	wikicat_Capitals_in_Asia	279	43	236	5.488372093023256
Andrey_Movsisyan	wikicat_FC_Lokomotiv_Nizhny_Novgorod_players	123	19	104	5.473684210526316
L.D._Alajuelense	wikicat_Association_football_clubs_established_in_1919	303	47	256	5.446808510638298
Ulisses_FC	wordnet_club_108227214	32	5	27	5.4
Teemu_Pukki	wikicat_FC_Schalke_04_players	51	8	43	5.375
County_Tipperary	wordnet_administrative_district_108491826	305	49	256	5.224489795918367
Trinity_University_(Texas)	wikicat_Educational_institutions_established_in_1873	4681	753	3928	5.2164674634794155
Blace	wordnet_administrative_district_108491826	185	30	155	5.166666666666667
Tivoli,_Lazio	wikicat_Archaeological_sites_in_Italy	55	9	46	5.111111111111111
Ikechi_Anya	wikicat_Watford_F.C._players	299	49	250	5.1020408163265305
Bernie_Lilavois	wikicat_Portland_Pythons_players	61	10	51	5.1
Club_Deportivo_Olimpia	wordnet_club_108227214	61	10	51	5.1
Punjab_region	wikicat_Empires_and_kingdoms_of_India	128	21	107	5.095238095238095
Enrico_Fermi_Award	wikicat_Physics_awards	79	13	66	5.076923076923077
Miami_University	wikicat_Universities_and_colleges_in_Ohio	127	21	106	5.0476190476190474
Michael_Black_(footballer)	wikicat_Boreham_Wood_F.C._players	470	78	392	5.0256410256410255
Chad_Harpur	wikicat_Dundee_F.C._players	6	1	5	5.0
FK_Vojvodina	wikicat_Football_clubs_in_Serbia	24	4	20	5.0
Bobby_Weale	wikicat_Welsh_footballers	18	3	15	5.0
Stuart_Nicholson	wikicat_Tamworth_F.C._players	6	1	5	5.0
Katsuhiro_Otomo	wikicat_Manga_artists	6	1	5	5.0
Uvalde,_Texas	wikicat_County_seats_in_Texas	6	1	5	5.0
Baltimore_County,_Maryland	wordnet_county_108546183	6	1	5	5.0
Jonathan_Walters	wikicat_English_footballers	6	1	5	5.0
Apocalypse_Now	wikicat_American_war_films	6	1	5	5.0
Raša,_Istria_County	wikicat_Municipalities_of_Croatia	6	1	5	5.0
Greg_Strong	wikicat_Scottish_Premier_League_players	6	1	5	5.0
Santos	wikicat_Port_cities_in_Brazil	6	1	5	5.0
Dino_Fava	wikicat_A.S._Varese_1910_players	12	2	10	5.0
University_of_Münster	wikicat_Universities_in_Germany	6	1	5	5.0
Ravi_Shankar	wikicat_20th-century_composers	6	1	5	5.0
Leandro_Bernardi_Silva	wikicat_Paysandu_Sport_Club_players	114	19	95	5.0
Zoran_Milinković_(footballer)	wikicat_Expatriate_footballers_in_France	12	2	10	5.0
Finland_national_football_team	wikicat_National_sports_teams_of_Finland	65	11	54	4.909090909090909
New_Orleans	wikicat_Port_cities	1013	172	841	4.8895348837209305
Rudolf_Peierls	wikicat_Materials_scientists_and_engineers	1781	303	1478	4.877887788778878
Little_Rock,_Arkansas	wikicat_Cities_in_the_United_States	94	16	78	4.875
Wisła_Kraków	wikicat_Basketball_teams_in_Poland	58	10	48	4.8
Clackmannanshire	wordnet_county_108546183	16245	2816	13429	4.7688210227272725
Wellington_Gonçalves_Amorim	wikicat_Associação_Desportiva_São_Caetano_players	23	4	19	4.75
Chaudière-Appalaches	wordnet_administrative_district_108491826	23	4	19	4.75
Félix_Ricardo_Torres	wikicat_Hércules_CF_footballers	46	8	38	4.75
Sheffield	wikicat_Towns_in_South_Yorkshire	63	11	52	4.7272727272727275
The_Story_of_Alexander_Graham_Bell	wikicat_Black-and-white_films	17	3	14	4.666666666666667
Motala	wikicat_Municipalities_of_Sweden	17	3	14	4.666666666666667
Yago_Alonso-Fueyo_Sako	wikicat_People_from_Abidjan	175	31	144	4.645161290322581
de/Dolný_Zemplín	wikicat_Regions_of_Slovakia	45	8	37	4.625
Hermann_Hreiðarsson	wikicat_Crystal_Palace_F.C._players	73	13	60	4.615384615384615
Lukáš_Zelenka	wikicat_Manisaspor_footballers	429	77	352	4.571428571428571
Nobel_Memorial_Prize_in_Economic_Sciences	wordnet_award_106696483	206	37	169	4.5675675675675675
MFK_Košice	wordnet_club_108227214	22	4	18	4.5
Windham_County,_Connecticut	wordnet_county_108546183	33	6	27	4.5
August_Wilhelm_von_Hofmann	wikicat_Ethnic_German_people	11	2	9	4.5
Alianza_F.C.	wikicat_Football_clubs_in_El_Salvador	889	162	727	4.487654320987654
Rosa_Luxemburg	wikicat_20th-century_women	307	56	251	4.482142857142857
IEEE_Edison_Medal	wikicat_Engineering_awards	369	68	301	4.426470588235294
Étoile_Carouge_FC	wikicat_Football_clubs_in_Switzerland	227	42	185	4.404761904761905
Edgar_Award	wikicat_American_film_awards	27	5	22	4.4
Hapoel_Nir_Ramat_HaSharon_F.C.	wikicat_Football_clubs_in_Israel	81	15	66	4.4
Bob_Hope	wikicat_British_humorists	172	32	140	4.375
Ballon_d'Or_(1956–2009)	wordnet_award_106696483	75	14	61	4.357142857142857
Mato_Neretljak	wikicat_Expatriate_footballers_in_South_Korea	16	3	13	4.333333333333333
Yevhen_Lutsenko	wikicat_Ukrainian_expatriate_footballers	16	3	13	4.333333333333333
Dan_Aykroyd	wordnet_comedian_109940146	53	10	43	4.3
Jared_Borgetti	wikicat_Cruz_Azul_footballers	53	10	43	4.3
Iván_Guerrero	wikicat_San_Jose_Earthquakes_players	21	4	17	4.25
Mars_Attacks!	wikicat_American_comedy_science_fiction_films	84	16	68	4.25
Tisch_School_of_the_Arts	wikicat_Educational_institutions_established_in_1965	1065	207	858	4.144927536231884
Des_Plaines,_Illinois	wikicat_Populated_places_established_in_1852	6835	1333	5502	4.127531882970743
Ian_Moores	wikicat_Bolton_Wanderers_F.C._players	41	8	33	4.125
Michael_Nyman	wikicat_Virgin_Records_artists	594	116	478	4.120689655172414
Central_Banat_District	wikicat_Districts_of_Serbia	46	9	37	4.111111111111111
Laurent_Schwartz	wikicat_French_atheists	56	11	45	4.090909090909091
Eric_Idle	wikicat_21st-century_composers	5864	1164	4700	4.037800687285223
Aaran_Lines	wikicat_VfL_Osnabrück_players	2395	476	1919	4.031512605042017
Émile_Mpenza	wikicat_1998_FIFA_World_Cup_players	186	37	149	4.027027027027027
Migen_Memelli	wikicat_KS_Teuta_Durrës_players	5	1	4	4.0
Indian_Ocean	wikicat_Oceans	5	1	4	4.0
Hendrich_Miller_Meireles_Bernardo	wikicat_Living_people	5	1	4	4.0
GLAAD_Media_Award	wikicat_American_television_awards	10	2	8	4.0
June_Allyson	wikicat_People_from_New_York_City	5	1	4	4.0
Amarjeet_Sohi	wikicat_Living_people	5	1	4	4.0
Rotherham_United_F.C.	wikicat_Football_League_clubs	5	1	4	4.0
Kittitas_County,_Washington	wikicat_Washington_(state)_counties	5	1	4	4.0
Port-au-Prince	wikicat_Capitals_in_North_America	5	1	4	4.0
Evesham_United_F.C.	wordnet_club_108227214	5	1	4	4.0
Islamabad	wikicat_Planned_capitals	5	1	4	4.0
Carlisle_United_F.C.	wordnet_club_108227214	5	1	4	4.0
FC_Levadia_Tallinn	wikicat_Meistriliiga_clubs	5	1	4	4.0
Sudan	wikicat_Least_developed_countries	5	1	4	4.0
Jürgen_Moser	wikicat_People_from_Königsberg	598	121	477	3.9421487603305785
Richard_Feynman	wikicat_Quantum_physicists	84	17	67	3.9411764705882355
C._S._Lewis	wikicat_Fantasy_writers	676	137	539	3.934306569343066
Michael_Hughes_(footballer)	wikicat_Manchester_City_F.C._players	74	15	59	3.933333333333333
Costa-Gavras	wikicat_French_film_directors	477	97	380	3.917525773195876
Nazir_Kazharov	wikicat_FC_Volgar_Astrakhan_players	245	50	195	3.9
Paul_Dickov	wikicat_Leeds_United_A.F.C._players	39	8	31	3.875
North_Holland	wikicat_Peninsulas_of_Europe	523	108	415	3.8425925925925926
Stuart_Fleetwood	wikicat_Cardiff_City_F.C._players	53	11	42	3.8181818181818183
Clinton_County,_Ohio	wordnet_county_108546183	48	10	38	3.8
Christian_Bassila	wikicat_Bundesliga_players	24	5	19	3.8
Alex_Afonso	wikicat_FC_Alverca_players	2546	533	2013	3.776735459662289
Manuel_Almunia	wikicat_Watford_F.C._players	57	12	45	3.75
Cyprus	wikicat_States_and_territories_established_in_1960	2468	521	1947	3.7370441458733206
Beloit,_Wisconsin	wordnet_administrative_district_108491826	71	15	56	3.7333333333333334
Palm_Springs,_California	wordnet_administrative_district_108491826	85	18	67	3.7222222222222223
ARIA_Music_Awards	wordnet_award_106696483	118	25	93	3.72
Transylvania	wikicat_Former_countries_in_Europe	2874	609	2265	3.7192118226600983
Andy_Williams_(Jamaican_footballer)	wikicat_1998_FIFA_World_Cup_players	1076	229	847	3.6986899563318776
Ezequiel_Lavezzi	wikicat_People_from_Santa_Fe_Province	42	9	33	3.6666666666666665
Apocalypse_Now	wikicat_Vietnam_War_films	56	12	44	3.6666666666666665
Daisuke_Matsui	wikicat_PFC_Levski_Sofia_players	14	3	11	3.6666666666666665
Alex_Mineiro	wikicat_Esporte_Clube_Vitória_players	42	9	33	3.6666666666666665
Hameur_Bouazza	wikicat_Fulham_F.C._players	162	35	127	3.6285714285714286
Gary_Barlow	wikicat_English_keyboardists	37	8	29	3.625
Zeeland	wikicat_Provinces_of_the_Netherlands	37	8	29	3.625
Julio_César_Uribe	wikicat_1987_Copa_América_players	189	41	148	3.6097560975609757
Peter_Debye	wikicat_People_from_Maastricht	4265	927	3338	3.6008629989212513
Nicolae_Iorga	wikicat_Romanian_orientalists	55	12	43	3.5833333333333335
Jerusalem	wikicat_Populated_places_in_the_West_Bank	32	7	25	3.5714285714285716
Piers_Anthony	wikicat_Science_fiction_fans	32	7	25	3.5714285714285716
Bob_Hope	wikicat_American_dancers	347	76	271	3.5657894736842106
Arezzo	wikicat_Cities_and_towns_in_Tuscany	73	16	57	3.5625
Kota_Bharu	wordnet_administrative_district_108491826	1734	382	1352	3.5392670157068062
Santos,_São_Paulo	wikicat_Populated_coastal_places_in_São_Paulo_(state)	59	13	46	3.5384615384615383
William_Thomson,_1st_Baron_Kelvin	wikicat_19th-century_physicists	438	97	341	3.515463917525773
David_Seaman	wikicat_Arsenal_F.C._players	9	2	7	3.5
Kathy_Bates	wikicat_21st-century_actresses	9	2	7	3.5
Nélson_Marcos	wikicat_Expatriate_footballers_in_Italy	36	8	28	3.5
Lee_Hyung-sang	wikicat_HNK_Šibenik_players	9	2	7	3.5
Östergötland	wikicat_Provinces_of_Sweden	7114	1588	5526	3.4798488664987404
Jersey_City,_New_Jersey	wikicat_Populated_places_on_the_Underground_Railroad	206	46	160	3.4782608695652173
Anand_Raj_Anand	wordnet_artist_109812338	58	13	45	3.4615384615384617
Calgary_Boomers	wikicat_Defunct_association_football_clubs	578	130	448	3.4461538461538463
Detroit_Safari	wikicat_Continental_Indoor_Soccer_League_teams	40	9	31	3.4444444444444446
Alex_Bruce_(footballer,_born_1984)	wikicat_People_from_Norwich	713	161	552	3.4285714285714284
Dário_Monteiro	wikicat_Expatriate_footballers_in_Brazil	628	142	486	3.4225352112676055
Arne_Friedrich	wikicat_Germany_B_international_footballers	150	34	116	3.411764705882353
Gustavo_Biscayzacú	wikicat_National_Soccer_League_(Australia)_players	185	42	143	3.4047619047619047
Murat_Ocak	wikicat_Karşıyaka_S.K._footballers	1006	229	777	3.393013100436681
Port_Moresby	wikicat_Populated_places_established_in_1873	6061	1382	4679	3.385672937771346
Lisa_De_Vanna	wikicat_Expatriate_footballers_in_Sweden	241	55	186	3.381818181818182
Club_Universidad_Nacional	wordnet_club_108227214	61	14	47	3.357142857142857
Jay_Mohr	wikicat_Living_people	26	6	20	3.3333333333333335
Jordi_Gómez	wikicat_Sunderland_A.F.C._players	201	47	154	3.276595744680851
Alfred_North_Whitehead	wikicat_Academics_of_Imperial_College_London	192	45	147	3.2666666666666666
Martin_Luther_King,_Jr.	wikicat_International_opponents_of_apartheid_in_South_Africa	285	67	218	3.253731343283582
Sani_Kaita	wikicat_Iraklis_Thessaloniki_F.C._players	17	4	13	3.25
Buckethead	wikicat_Musicians_from_California	51	12	39	3.25
Ivory_Coast_national_football_team	wordnet_football_team_108080025	208	49	159	3.2448979591836733
Meryl_Streep	wikicat_American_people_of_Swiss_descent	3276	772	2504	3.243523316062176
Louis_XV_of_France	wikicat_People_from_Paris	220	52	168	3.230769230769231
Winnipeg_Jets	wikicat_Sports_clubs_established_in_1999	55	13	42	3.230769230769231
Newport,_Wales	wikicat_Populated_coastal_places_in_Wales	21	5	16	3.2
John_Cleese	wikicat_British_television_actors	126	30	96	3.2
Eduardo_Ratinho	wikicat_Toulouse_FC_players	5073	1210	3863	3.1925619834710743
Mauro_Sérgio_Viriato_Mendes	wikicat_Santos_Futebol_Clube_players	25	6	19	3.1666666666666665
David_Hume	wikicat_Atheist_philosophers	58	14	44	3.142857142857143
Siyabonga_Nomvethe	wikicat_People_from_Durban	1417	343	1074	3.131195335276968
Club_Atlético_Platense	wordnet_club_108227214	66	16	50	3.125
Cagliari	wikicat_Populated_places_established_in_the_7th_century_BC	33	8	25	3.125
William_Thomson,_1st_Baron_Kelvin	wikicat_British_scientists	202	49	153	3.122448979591837
Vladan_Milovanović	wikicat_SC_Austria_Lustenau_players	828	201	627	3.1194029850746268
FC_Volochanin-Ratmir_Vyshny_Volochyok	wikicat_Association_football_clubs_established_in_1989	1082	263	819	3.1140684410646386
Terry_Boyle	wikicat_Cardiff_City_F.C._players	49	12	37	3.0833333333333335
John_Stuart_Mill	wikicat_Atheist_feminists	3697	911	2786	3.058177826564215
Ilian_Iliev	wikicat_Bursaspor_footballers	81	20	61	3.05
Buenos_Aires	wikicat_Populated_places_established_in_1580	12684	3169	9515	3.0025244556642474
Freeman_Dyson	wikicat_English_emigrants_to_the_United_States	12	3	9	3.0
Deportivo_Saprissa	wordnet_club_108227214	8	2	6	3.0
CD_Atlético_Baleares	wordnet_club_108227214	12	3	9	3.0
Palo_Alto,_California	wikicat_Cities_in_Santa_Clara_County,_California	8	2	6	3.0
Fritz_Lang	wikicat_English-language_film_directors	8	2	6	3.0
Florence	wikicat_World_Heritage_Sites_in_Italy	8	2	6	3.0
Colin_Firth	wikicat_Living_people	4	1	3	3.0
Tomislav_Bušić	wikicat_Expatriate_footballers_in_Israel	12	3	9	3.0
Jari_Litmanen	wikicat_La_Liga_footballers	4	1	3	3.0
Darren_Mansaram	wikicat_English_footballers	4	1	3	3.0
SC_Verl	wikicat_Football_clubs_in_North_Rhine-Westphalia	4	1	3	3.0
Boston_Breakers	wikicat_Massachusetts_soccer_clubs	4	1	3	3.0
Oracle_Corporation	wikicat_Publicly_traded_companies_of_the_United_States	4	1	3	3.0
FC_Progresul_București	wordnet_club_108227214	4	1	3	3.0
West_Oxfordshire	wikicat_Local_government_districts_of_South_East_England	4	1	3	3.0
Virtus_Entella	wikicat_Lega_Pro_Seconda_Divisione_clubs	4	1	3	3.0
Dave_Mitchell_(footballer)	wikicat_Australian_soccer_players	4	1	3	3.0
Luxembourg_(city)	wikicat_Towns_in_Luxembourg	4	1	3	3.0
Maxime_Josse	wikicat_France_under-21_international_footballers	8	2	6	3.0
Berkeley,_California	wordnet_administrative_district_108491826	4	1	3	3.0
Valencia	wikicat_World_Heritage_Sites_in_Spain	4	1	3	3.0
Polonia_Warsaw	wordnet_club_108227214	4	1	3	3.0
Tamia	wikicat_Women	4	1	3	3.0
NK_GOŠK_Gabela	wordnet_club_108227214	4	1	3	3.0
François_Remetter	wikicat_French_footballers	8	2	6	3.0
Robert_Fogel	wordnet_economist_110043643	4	1	3	3.0
Daphne_du_Maurier	wikicat_English_writers	4	1	3	3.0
Narbonne	wikicat_Archaeological_sites_in_France	4	1	3	3.0
Philip_Pullman	wikicat_Guardian_Children's_Fiction_Prize_winners	643	162	481	2.9691358024691357
Guilherme_de_Cássio_Alves	wikicat_Segunda_División_footballers	71	18	53	2.9444444444444446
Valletta	wikicat_World_Heritage_Sites_in_Malta	8421	2139	6282	2.9368863955119213
Duchy_of_Styria	wikicat_Historical_subdivisions_of_the_Slovene_ethnic_territory	4316	1097	3219	2.93436645396536
Suat_Usta	wikicat_Antalyaspor_footballers	235	60	175	2.9166666666666665
Friedrich_Hayek	wikicat_People_associated_with_the_London_School_of_Economics	184	47	137	2.9148936170212765
Dietmar_Hamann	wikicat_1998_FIFA_World_Cup_players	70	18	52	2.888888888888889
Yaoundé	wikicat_Capitals_in_Africa	31	8	23	2.875
Janet_Frame	wikicat_New_Zealand_short_story_writers	267	69	198	2.869565217391304
Inverell	wordnet_site_108651247	27	7	20	2.857142857142857
Dynamo_Dresden	wikicat_Association_football_clubs_established_in_1953	894	233	661	2.836909871244635
Jacques_Chirac	wikicat_Anti–death_penalty_activists	46	12	34	2.8333333333333335
Jim_Clark_(film_editor)	wikicat_British_film_editors	84	22	62	2.8181818181818183
Lenin_Prize	wikicat_Literary_awards	439	115	324	2.8173913043478263
Nathan_Abbey	wikicat_Boston_United_F.C._players	61	16	45	2.8125
Pasadena,_California	wikicat_Populated_places_established_in_1874	297	78	219	2.8076923076923075
André_Weil	wikicat_Lycée_Saint-Louis_alumni	38	10	28	2.8
Haugesund	wikicat_Populated_coastal_places_in_Norway	19	5	14	2.8
OFK_Beograd	wikicat_Football_clubs_in_Yugoslavia	38	10	28	2.8
Gabriel_Enrique_Gómez	wikicat_Junior_F.C._footballers	91	24	67	2.7916666666666665
Exeter,_New_Hampshire	wikicat_Towns_in_New_Hampshire	16045	4252	11793	2.7735183443085605
Amherst_College	wikicat_Educational_institutions_established_in_1821	1602	426	1176	2.76056338028169
Steve_Croudson	wikicat_Rhyl_F.C._players	1333	355	978	2.7549295774647886
Almería_Airport	wordnet_airport_102692232	15	4	11	2.75
Tazewell_County,_Virginia	wikicat_Virginia_counties	277	74	203	2.7432432432432434
Aurelio_Vidmar	wikicat_2001_FIFA_Confederations_Cup_players	82	22	60	2.727272727272727
Carl_Tiler	wikicat_Aston_Villa_F.C._players	119	32	87	2.71875
Steven_Caldwell	wikicat_Toronto_FC_players	550	148	402	2.7162162162162162
André_Oliveira_de_Lima	wikicat_2._Bundesliga_players	26	7	19	2.7142857142857144
José_Augusto_Freitas_Sousa	wikicat_Paysandu_Sport_Club_players	59	16	43	2.6875
Nikita_Rukavytsya	wikicat_Ukrainian_people	3217	873	2344	2.6849942726231384
Franco_Da_Dalt	wikicat_A.S._Varese_1910_players	125	34	91	2.676470588235294
Benoit_Mandelbrot	wikicat_Harvard_University_people	10207	2780	7427	2.67158273381295
Craig_Beattie	wikicat_Celtic_F.C._players	22	6	16	2.6666666666666665
Paulette_Goddard	wikicat_Actors_from_New_York_City	22	6	16	2.6666666666666665
Roy_Scheider	wikicat_21st-century_American_male_actors	11	3	8	2.6666666666666665
Garry_Thompson_(footballer_born_1959)	wikicat_Sheffield_Wednesday_F.C._players	33	9	24	2.6666666666666665
Inverness	wordnet_site_108651247	44	12	32	2.6666666666666665
Julian_Alsop	wikicat_Newport_County_A.F.C._players	22	6	16	2.6666666666666665
Ian_McLagan	wikicat_Rock_keyboardists	11	3	8	2.6666666666666665
Roger_Hodgson	wikicat_British_composers	11	3	8	2.6666666666666665
Kid_Rock	wikicat_21st-century_American_musicians	466	128	338	2.640625
David_Seaman	wikicat_1998_FIFA_World_Cup_players	80	22	58	2.6363636363636362
Roger_Milla	wikicat_1994_FIFA_World_Cup_players	69	19	50	2.6315789473684212
G._K._Chesterton	wikicat_Alumni_of_University_College_London	1517	418	1099	2.6291866028708135
Henry_Fonda	wikicat_Male_actors_from_Omaha,_Nebraska	94	26	68	2.6153846153846154
Ipswich_Town_F.C.	wikicat_Football_League_Championship_clubs	18	5	13	2.6
Rudolf_Peierls	wikicat_Lorentz_Medal_winners	36	10	26	2.6
Apocalypse_Now	wikicat_Films_based_on_works_by_Joseph_Conrad	36	10	26	2.6
Delron_Buckley	wikicat_Borussia_Dortmund_players	36	10	26	2.6
Jørgen_Kristensen	wikicat_Calgary_Boomers_players	196	55	141	2.5636363636363635
C.F._Monterrey	wikicat_Association_football_clubs_established_in_1945	4260	1196	3064	2.5618729096989967
Kuala_Lumpur	wordnet_administrative_district_108491826	39	11	28	2.5454545454545454
John_Cassavetes	wikicat_American_film_editors	131	37	94	2.5405405405405403
Warri	wordnet_administrative_district_108491826	14	4	10	2.5
Sežana	wordnet_administrative_district_108491826	14	4	10	2.5
French_Algeria	wordnet_country_108544813	14	4	10	2.5
Jeff_Minton	wikicat_Welling_United_F.C._players	420	120	300	2.5
Mario_Bolatti	wikicat_Expatriate_footballers_in_Italy	7	2	5	2.5
Sociedade_Esportiva_do_Gama	wikicat_Football_clubs_in_Brazil	7	2	5	2.5
Avignon	wikicat_Prefectures_in_France	7	2	5	2.5
FK_Atlantas	wikicat_Football_clubs_in_the_Soviet_Union	7	2	5	2.5
Mojave_Desert	wikicat_Deserts_of_North_America	7	2	5	2.5
Bud_Molin	wordnet_person_100007846	7	2	5	2.5
Pierre_Pflimlin	wikicat_Government_ministers_of_France	14	4	10	2.5
Diego_Perrone	wikicat_Club_Nacional_de_Football_players	112	32	80	2.5
Marijan_Kovačević	wikicat_MSV_Duisburg_players	7	2	5	2.5
Ittihad_FC	wordnet_club_108227214	7	2	5	2.5
Béla_Sárosi	wikicat_Hungary_international_footballers	7	2	5	2.5
Nikica_Jelavić	wikicat_Austrian_Football_Bundesliga_players	7	2	5	2.5
Australian_Capital_Territory	wikicat_Capital_districts_and_territories	1106	317	789	2.4889589905362777
Galilee	wikicat_New_Testament_places	115	33	82	2.484848484848485
Atlético_Nacional	wikicat_Association_football_clubs_established_in_1947	643	185	458	2.4756756756756757
Charlie_Davies	wikicat_American_soccer_players	52	15	37	2.466666666666667
University_of_Königsberg	wikicat_Universities_and_colleges_in_the_Polish–Lithuanian_Commonwealth	15894	4586	11308	2.4657653728739644
Valentino_Lai	wikicat_Malmö_FF_players	83	24	59	2.4583333333333335
Goole_A.F.C.	wikicat_Northern_Premier_League_clubs	121	35	86	2.4571428571428573
Lulu_(singer)	wikicat_Scottish_television_actresses	38	11	27	2.4545454545454546
Ronald_Coase	wikicat_English_Nobel_laureates	169	49	120	2.4489795918367347
Portugal_national_football_team	wikicat_National_sports_teams_of_Portugal	31	9	22	2.4444444444444446
Michel_Debré	wikicat_French_people_of_the_Algerian_War	31	9	22	2.4444444444444446
Kylie_Minogue	wikicat_20th-century_actresses	62	18	44	2.4444444444444446
Viggo_Mortensen	wikicat_Canadian_emigrants_to_the_United_States	196	57	139	2.43859649122807
David_di_Donatello	wikicat_International_film_awards	110	32	78	2.4375
S.S._Lazio	wikicat_Association_football_clubs_established_in_1900	48	14	34	2.4285714285714284
Carlos_Alberto_de_Jesus	wikicat_Goiás_Esporte_Clube_players	48	14	34	2.4285714285714284
Raoul_Bott	wikicat_Hungarian_mathematicians	24	7	17	2.4285714285714284
Racing_de_Ferrol	wikicat_Football_clubs_in_Spain	192	56	136	2.4285714285714284
Christian_Alder	wikicat_VfR_Aalen_players	362	106	256	2.4150943396226414
Bnei_Yehuda_Tel_Aviv_F.C.	wikicat_Jewish_football_clubs	17	5	12	2.4
John_Farnham	wikicat_Australian_pop_singers	34	10	24	2.4
Rot-Weiss_Essen	wikicat_Association_football_clubs_established_in_1907	61	18	43	2.388888888888889
SC_Telstar	wordnet_club_108227214	71	21	50	2.380952380952381
Karachi	wikicat_Cities_of_Pakistan	27	8	19	2.375
Oscar_Dertycia	wikicat_Club_Atlético_Belgrano_footballers	37	11	26	2.3636363636363638
Hervé_de_Charette	wikicat_HEC_Paris_alumni	131	39	92	2.358974358974359
Mario_Puzo	wikicat_American_people_of_World_War_II	762	227	535	2.356828193832599
Rik_Mayall	wikicat_English_male_comedians	107	32	75	2.34375
Danny_Califf	wikicat_American_soccer_players	10	3	7	2.3333333333333335
Goiás_Esporte_Clube	wordnet_club_108227214	10	3	7	2.3333333333333335
Walsall_F.C.	wordnet_club_108227214	20	6	14	2.3333333333333335
Lester_James_Peries	wikicat_Living_people	10	3	7	2.3333333333333335
Swindon_Town_F.C.	wikicat_Football_clubs_in_England	10	3	7	2.3333333333333335
Georges_Bataille	wikicat_French_novelists	10	3	7	2.3333333333333335
MGM_Grand_Garden_Arena	wikicat_Entertainment_venues_in_the_United_States	40	12	28	2.3333333333333335
RBC_Roosendaal	wordnet_club_108227214	80	24	56	2.3333333333333335
Bartosz_Tarachulski	wikicat_Dunfermline_Athletic_F.C._players	1096	329	767	2.3313069908814588
Darren_Mansaram	wikicat_Worksop_Town_F.C._players	309	93	216	2.3225806451612905
Robin_Cook_(American_novelist)	wikicat_American_physicians	1284	387	897	2.317829457364341
Diagoras_F.C.	wikicat_Association_football_clubs_established_in_1905	1483	449	1034	2.3028953229398663
Adolf_Hitler	wikicat_German_painters	3098	939	2159	2.2992545260915866
Club_Sportivo_Cerrito	wikicat_Football_clubs_in_Uruguay	125	38	87	2.289473684210526
Craig_Armstrong_(footballer)	wikicat_Eastwood_Town_F.C._players	2028	617	1411	2.286871961102107
Ralph_Hasenhüttl	wikicat_FK_Austria_Wien_players	23	7	16	2.2857142857142856
Rouen	wikicat_Viking_Age_populated_places	10191	3106	7085	2.2810688989053447
Jim_Rodwell	wikicat_Sabah_FA_players	538	164	374	2.2804878048780486
Seïd_Khiter	wikicat_AC_Ajaccio_players	59	18	41	2.2777777777777777
Ernest_Orlando_Lawrence_Award	wikicat_Physics_awards	111	34	77	2.264705882352941
Columbia_Law_School	wikicat_Educational_institutions_established_in_1858	1930	593	1337	2.254637436762226
Kherson	wikicat_Populated_places_established_in_1778	13	4	9	2.25
Janez_Zavrl_(footballer)	wikicat_Expatriate_footballers_in_Norway	13	4	9	2.25
Jade_North	wikicat_Brisbane_Roar_FC_players	107	33	74	2.242424242424242
Strasbourg	wikicat_Populated_places_on_the_Rhine	132	41	91	2.2195121951219514
CFR_Cluj	wikicat_Association_football_clubs_established_in_1907	193	60	133	2.216666666666667
Michael_Thwaite	wikicat_Australian_expatriates_in_Romania	1454	453	1001	2.2097130242825607
Thessaloniki	wikicat_Port_cities	32	10	22	2.2
Konrad_Adenauer	wikicat_Grand_Officers_of_the_Order_of_Merit_of_the_Italian_Republic	51	16	35	2.1875
Albert_Einstein	wikicat_German_physicists	57	18	39	2.1666666666666665
The_Hague	wikicat_Port_cities_and_towns_of_the_North_Sea	76	24	52	2.1666666666666665
Edmund_Husserl	wikicat_People_condemned_by_Nazi_courts	117	37	80	2.1621621621621623
Nery_Castillo	wikicat_Mexican_footballers	66	21	45	2.142857142857143
Tours_FC	wikicat_Football_clubs_in_France	25	8	17	2.125
Robert_Lucas,_Jr.	wikicat_Presidents_of_the_Econometric_Society	81	26	55	2.1153846153846154
Wellington_Saints	wordnet_club_108227214	897	288	609	2.1145833333333335
Douglas_Engelbart	wikicat_People_from_Portland,_Oregon	358	115	243	2.1130434782608694
Michel_de_Montaigne	wikicat_French_abolitionists	2093	674	1419	2.105341246290801
Tiro_Federal	wikicat_Association_football_clubs_established_in_1905	59	19	40	2.1052631578947367
Atlético_Clube_Goianiense	wikicat_Association_football_clubs_established_in_1937	183	59	124	2.1016949152542375
John_Henry_Newman	wikicat_Converts_to_Roman_Catholicism_from_Anglicanism	16365	5292	11073	2.0924036281179137
Carlos_Pavón	wikicat_Udinese_Calcio_players	538	174	364	2.0919540229885056
El_Salvador	wikicat_States_and_territories_established_in_1842	2825	918	1907	2.077342047930283
Środa_Śląska_County	wikicat_Counties_of_Poland	46	15	31	2.066666666666667
Christopher_Guest	wikicat_English_television_writers	104	34	70	2.0588235294117645
Martin_Woods	wikicat_Scotland_under-21_international_footballers	55	18	37	2.0555555555555554
Aldous_Huxley	wikicat_British_essayists	64	21	43	2.0476190476190474
Gerry_Francis	wikicat_Exeter_City_F.C._players	70	23	47	2.0434782608695654
Cameroon_national_football_team	wordnet_football_team_108080025	286	94	192	2.0425531914893615
The_London_Studios	wordnet_building_102913152	103	34	69	2.0294117647058822
Jeonnam_Dragons	wikicat_K_League_clubs	1186	394	792	2.010152284263959
Georg_Wilhelm_Friedrich_Hegel	wikicat_Protestant_philosophers	3	1	2	2.0
Nikola_Karčev	wikicat_Association_football_defenders	12	4	8	2.0
Greater_St._Louis	wordnet_administrative_district_108491826	3	1	2	2.0
Kerrang!_Awards	wikicat_Music_awards	12	4	8	2.0
Dorival_Júnior	wikicat_Living_people	3	1	2	2.0
Beitar_Jerusalem_F.C.	wikicat_Football_clubs_in_Israel	3	1	2	2.0
Fleetwood_Town_F.C.	wordnet_club_108227214	3	1	2	2.0
Luciano_Henrique	wikicat_Santos_Futebol_Clube_players	12	4	8	2.0
St_Asaph	wikicat_Towns_in_Denbighshire	6	2	4	2.0
Eric_Idle	wikicat_British_artists	3	1	2	2.0
Vladivostok	wikicat_Port_cities_and_towns_in_Russia	3	1	2	2.0
Mounir_El_Hamdaoui	wikicat_Serie_A_footballers	3	1	2	2.0
Léon_Brillouin	wikicat_French_people	3	1	2	2.0
Associação_Atlética_Internacional_(Limeira)	wikicat_Association_football_clubs_established_in_1913	3	1	2	2.0
Nawaz_Sharif	wikicat_Pakistani_people	6	2	4	2.0
Nobel_Prize_in_Physics	wikicat_Physics_awards	3	1	2	2.0
Amartya_Sen	wordnet_scientist_110560637	3	1	2	2.0
Greifswald	wikicat_Port_cities	9	3	6	2.0
Poole	wikicat_Unitary_authority_districts_of_England	9	3	6	2.0
Donald_Davidson_(philosopher)	wikicat_American_philosophers	3	1	2	2.0
Lisbon_Region	wikicat_NUTS_2_statistical_regions_of_the_European_Union	6	2	4	2.0
John_Cleese	wikicat_British_film_actors	3	1	2	2.0
Netherlands	wikicat_Germanic_countries_and_territories	3	1	2	2.0
Vladimir_Vasilj	wikicat_NK_Varaždin_players	9	3	6	2.0
SC_Kriens	wordnet_club_108227214	9	3	6	2.0
Virginia_Commonwealth_University	wikicat_Public_universities	3	1	2	2.0
George_W._Bush	wikicat_American_people_of_Scottish_descent	3	1	2	2.0
Émile_Durkheim	wikicat_French_philosophers	3	1	2	2.0
Alan_Heim	wikicat_Living_people	9	3	6	2.0
Nick_Wright_(footballer_born_1987)	wikicat_Lincoln_City_F.C._players	3	1	2	2.0
Moldova	wikicat_Russian-speaking_countries_and_territories	3	1	2	2.0
José_Luis_Garcés	wikicat_San_Francisco_F.C._footballers	3	1	2	2.0
Harrison_Omoko	wikicat_FC_Arsenal_Kyiv_players	3	1	2	2.0
Hume_City_FC	wikicat_National_Premier_Leagues_clubs	3	1	2	2.0
Olivia_Newton-John	wikicat_Australian_television_actors	3	1	2	2.0
Lindsay_Lohan	wikicat_Actresses_from_New_York	27	9	18	2.0
Ricardo_Montalbán	wikicat_American_television_actors	18	6	12	2.0
Augsburg	wordnet_location_100027167	3	1	2	2.0
Mario_Bolatti	wikicat_Argentina_international_footballers	3	1	2	2.0
Beerschot_AC	wordnet_club_108227214	3	1	2	2.0
Jomo_Cosmos_F.C.	wordnet_club_108227214	3	1	2	2.0
Mario_Bolatti	wikicat_Primera_División_Argentina_players	3	1	2	2.0
Rovigo_Calcio	wordnet_club_108227214	3	1	2	2.0
Zhejiang	wikicat_Administrative_divisions_of_China	6	2	4	2.0
Harrogate_Town_F.C.	wordnet_club_108227214	6	2	4	2.0
Helsingborg	wikicat_Populated_places_in_Skåne_County	18	6	12	2.0
Fortaleza	wordnet_administrative_district_108491826	3	1	2	2.0
Roger_Penrose	wikicat_English_atheists	84	28	56	2.0
Hollywood_Party_(1934_film)	wikicat_American_musical_films	81	27	54	2.0
Raf_de_Gregorio	wikicat_Football_Kingz_F.C._players	3	1	2	2.0
Dennis_William_Sciama	wikicat_Academics_of_the_University_of_Cambridge	6	2	4	2.0
George_W._Bush	wikicat_American_people_of_Irish_descent	3	1	2	2.0
Silver_Star	wikicat_Military_awards_and_decorations_of_the_United_States	3	1	2	2.0
Tacloban	wikicat_Provincial_capitals_of_the_Philippines	6	2	4	2.0
Gliwice	wikicat_Cities_in_Silesia	3	1	2	2.0
Greg_Bear	wikicat_American_writers	3	1	2	2.0
FC_Lokomotiv_Nizhny_Novgorod	wikicat_Football_clubs_in_Russia	3	1	2	2.0
Craig_Nelson_(footballer)	wikicat_Brechin_City_F.C._players	6	2	4	2.0
Kaunas_Airport	wordnet_airport_102692232	21	7	14	2.0
Johnny_Taylor_(basketball)	wikicat_CB_Lucentum_Alicante_players	3	1	2	2.0
Aarón_Ñíguez	wikicat_Spanish_footballers	3	1	2	2.0
Meerut_district	wikicat_Districts_of_India	3	1	2	2.0
Gustav_Kirchhoff	wikicat_Fellows_of_the_Royal_Society	6	2	4	2.0
Fritz_Lang	wikicat_People_who_emigrated_to_escape_Nazism	15	5	10	2.0
Olubayo_Adefemi	wikicat_People_from_Lagos	15	5	10	2.0
Second_Congo_War	wikicat_Civil_wars	15	5	10	2.0
Marcos_Alonso_Peña	wikicat_Racing_de_Santander_managers	3	1	2	2.0
Rome	wikicat_Holy_cities	6	2	4	2.0
Søren_Larsen	wikicat_Ligue_1_players	3	1	2	2.0
Brodnica_County	wordnet_administrative_district_108491826	45	15	30	2.0
Celtic_Nation_F.C.	wikicat_Association_football_clubs_established_in_2005	462	155	307	1.9806451612903226
Joe_Pesci	wikicat_People_from_Belleville,_New_Jersey	4916	1650	3266	1.9793939393939395
Ludwig_Wittgenstein	wikicat_Austrian_agnostics	274	92	182	1.9782608695652173
Carlos_Casartelli	wikicat_UD_Salamanca_footballers	3965	1332	2633	1.9767267267267268
Kevin_Miller_(footballer)	wikicat_Footballers_from_Cornwall	4697	1590	3107	1.9540880503144653
Kamil_Grosicki	wikicat_FC_Sion_players	47	16	31	1.9375
Taranto	wikicat_Ancient_Greek_sites_in_Italy	41	14	27	1.9285714285714286
Dammam	wikicat_Populated_places_established_in_1923	6258	2141	4117	1.9229332087809434
Thomas_Paine	wikicat_English_inventors	3251	1114	2137	1.9183123877917414
Émile_Picard	wikicat_People_from_Paris	35	12	23	1.9166666666666667
Comoros	wikicat_Archipelagoes_of_the_Indian_Ocean	172	59	113	1.9152542372881356
Ethio-Somali_War	wikicat_Wars_involving_the_Soviet_Union	32	11	21	1.9090909090909092
Joseph-Désiré_Job	wikicat_1998_FIFA_World_Cup_players	96	33	63	1.9090909090909092
Paul_Simon	wikicat_Jewish_American_musicians	93	32	61	1.90625
Jack_Cork	wikicat_Burnley_F.C._players	119	41	78	1.9024390243902438
Christopher_Guest	wikicat_Barons_in_the_Peerage_of_the_United_Kingdom	5522	1903	3619	1.9017341040462428
Charles_Durning	wikicat_American_people_of_World_War_II	235	81	154	1.9012345679012346
Gene_Kelly	wikicat_American_choreographers	681	235	446	1.897872340425532
Hertha_BSC	wikicat_Association_football_clubs_established_in_1892	428	148	280	1.8918918918918919
Caxias_do_Sul	wikicat_Cities_in_Rio_Grande_do_Sul	153	53	100	1.8867924528301887
Friedrich_Hayek	wikicat_Austrian_School_economists	23	8	15	1.875
Melissa_Tancredi	wikicat_Footballers_at_the_2007_Pan_American_Games	138	48	90	1.875
Eric_Idle	wikicat_English_male_comedians	66	23	43	1.8695652173913044
Carmen_Electra	wikicat_Participants_in_American_reality_television_series	650	227	423	1.8634361233480177
Västra_Götaland_County	wikicat_Counties_of_Sweden	20	7	13	1.8571428571428572
University_of_Portland	wikicat_Universities_and_colleges_accredited_by_the_Northwest_Commission_on_Colleges_and_Universities	20	7	13	1.8571428571428572
Daniel_Majstorović	wikicat_SC_Fortuna_Köln_players	1258	441	817	1.8526077097505669
Leandro_Bernardi_Silva	wikicat_Adap_Galo_Maringá_Football_Club_players	975	342	633	1.8508771929824561
Ernst_Mach	wikicat_Austrian_scientists	116	41	75	1.829268292682927
Nicola_Amoruso	wikicat_Modena_F.C._players	48	17	31	1.8235294117647058
Darren_Mansaram	wikicat_Armthorpe_Welfare_F.C._players	765	271	494	1.8228782287822878
John_Grisham	wikicat_People_from_Oxford,_Mississippi	152	54	98	1.8148148148148149
Rabat	wordnet_site_108651247	768	273	495	1.8131868131868132
Gary_Forrester	wikicat_People_from_Wellington_City	1192	425	767	1.8047058823529412
Ronald_Reagan	wikicat_Actors_from_California	315	113	202	1.7876106194690264
Charlotte_Rampling	wikicat_Pop_singers	139	50	89	1.78
Boaz_Myhill	wikicat_England_youth_international_footballers	133	48	85	1.7708333333333333
Joseph-Désiré_Job	wikicat_K._Lierse_S.K._players	526	190	336	1.768421052631579
Talia_Shire	wikicat_Actresses_from_New_York	315	114	201	1.763157894736842
David_Lynch	wikicat_American_music_video_directors	268	97	171	1.7628865979381443
Pallalcesto_Amatori_Udine	wikicat_Sports_clubs_established_in_1999	8980	3251	5729	1.7622270070747463
Aaran_Lines	wikicat_Rochester_Rhinos_players	2270	825	1445	1.7515151515151515
Wakefield	wikicat_County_towns_in_England	66	24	42	1.75
Dan_Eggen	wikicat_Norwegian_football_managers	99	36	63	1.75
Robert_Bunsen	wikicat_German_chemists	11	4	7	1.75
Olympique_Lyonnais	wikicat_Multi-sport_clubs_in_France	33	12	21	1.75
War_of_the_Second_Coalition	wikicat_Wars_involving_Denmark	11	4	7	1.75
Order_of_the_Nile	wikicat_Civil_awards_and_decorations	205	75	130	1.7333333333333334
Søren_Larsen	wikicat_Danish_Superliga_players	30	11	19	1.7272727272727273
Richard_Dawkins	wikicat_English_atheists	30	11	19	1.7272727272727273
Alfred_North_Whitehead	wikicat_Presidents_of_the_Aristotelian_Society	531	195	336	1.7230769230769232
Willard_Van_Orman_Quine	wikicat_Pragmatists	147	54	93	1.7222222222222223
Monica_(singer)	wikicat_People_from_Scottsdale,_Arizona	15464	5687	9777	1.7191841040970635
Alojz_Rebula	wikicat_Translators	38	14	24	1.7142857142857142
Michel_Debré	wikicat_Radical_Party_(France)_politicians	19	7	12	1.7142857142857142
Susan_Sontag	wikicat_American_essayists	19	7	12	1.7142857142857142
Rosa_Luxemburg	wikicat_German_atheists	76	28	48	1.7142857142857142
Nick_Cave	wikicat_Australian_actors	19	7	12	1.7142857142857142
Daphne_du_Maurier	wikicat_Women_short_story_writers	57	21	36	1.7142857142857142
Kazuyuki_Toda	wikicat_Expatriate_footballers_in_Singapore	46	17	29	1.7058823529411764
Martin_Andresen	wikicat_Wimbledon_F.C._players	46	17	29	1.7058823529411764
Richard_Edghill	wikicat_Footballers_from_Oldham	525	195	330	1.6923076923076923
Lublin_County	wikicat_Counties_of_Poland	70	26	44	1.6923076923076923
Devon	wikicat_Non-metropolitan_counties	207	77	130	1.6883116883116882
Suwon	wordnet_administrative_district_108491826	395	147	248	1.6870748299319729
Kumbakonam	wikicat_Cities_and_towns_in_Tamil_Nadu	51	19	32	1.6842105263157894
Pierre_Bérégovoy	wikicat_Socialist_Party_(France)_politicians	59	22	37	1.6818181818181819
U.S._Cremonese	wikicat_Association_football_clubs_established_in_1903	59	22	37	1.6818181818181819
Liv_Tyler	wikicat_Transcendental_Meditation_practitioners	3293	1234	2059	1.6685575364667746
I._M._Pei	wikicat_Living_people	152	57	95	1.6666666666666667
Colchester_United_F.C.	wikicat_Football_League_clubs	16	6	10	1.6666666666666667
Indios_de_Ciudad_Juárez	wikicat_Ascenso_MX_teams	8	3	5	1.6666666666666667
Charlotte_Gainsbourg	wikicat_French_singers	8	3	5	1.6666666666666667
Ricky_Gervais	wikicat_English_television_actors	8	3	5	1.6666666666666667
Norm_Macdonald	wikicat_Comedians	72	27	45	1.6666666666666667
John_G._Thompson	wikicat_Living_people	8	3	5	1.6666666666666667
James_Watson	wikicat_Phage_workers	177	67	110	1.6417910447761195
Guwançmuhammet_Öwekow	wikicat_Turkmenistan_footballers	29	11	18	1.6363636363636365
Anders_Jochumsen	wikicat_Lyngby_Boldklub_players	166	63	103	1.6349206349206349
Mitt_Romney	wikicat_State_governors_of_the_United_States	158	60	98	1.6333333333333333
Huachipato	wikicat_Football_clubs_in_Chile	21	8	13	1.625
Kossi_Agassa	wikicat_Hércules_CF_footballers	729	278	451	1.6223021582733812
Gmina_Łagów,_Lubusz_Voivodeship	wordnet_administrative_district_108491826	118	45	73	1.6222222222222222
Isidor_Isaac_Rabi	wikicat_Fellows_of_the_American_Association_for_the_Advancement_of_Science	118	45	73	1.6222222222222222
Rachel_Weisz	wikicat_English_people_of_Hungarian-Jewish_descent	1190	455	735	1.6153846153846154
Nicolae_Iorga	wikicat_Romanian_historians	68	26	42	1.6153846153846154
Gökhan_Bozkaya	wikicat_Giresunspor_footballers	47	18	29	1.6111111111111112
Alphonse_Tchami	wikicat_Boca_Juniors_footballers	688	264	424	1.606060606060606
Roy_Scheider	wikicat_Rutgers_University_alumni	6027	2315	3712	1.6034557235421167
Fred_Frith	wikicat_Rock_musicians	13	5	8	1.6
Barry_Manilow	wikicat_American_people_of_Irish_descent	70	27	43	1.5925925925925926
Alexander_Herzen	wikicat_Russian_novelists	44	17	27	1.588235294117647
Matteo_Momentè	wikicat_S.S._Sambenedettese_Calcio_players	308	119	189	1.588235294117647
Anthony_Eden	wikicat_British_politicians	62	24	38	1.5833333333333333
Eastern_Samar	wikicat_Provinces_of_the_Philippines	72	28	44	1.5714285714285714
James_Watson	wikicat_Nobel_laureates_in_Physiology_or_Medicine	1300	507	793	1.564102564102564
Tibet_Autonomous_Region	wordnet_administrative_district_108491826	28	11	17	1.5454545454545454
Aleksandr_Chertoganov	wikicat_Gabala_FC_players	28	11	17	1.5454545454545454
Yaroslav_Svorak	wikicat_FC_Dnepr_Mogilev_players	33	13	20	1.5384615384615385
Ioan_Sabău	wikicat_Romanian_expatriates_in_the_Netherlands	954	379	575	1.517150395778364
Joseph-Désiré_Job	wikicat_Diyarbakırspor_footballers	229	91	138	1.5164835164835164
Danny_Graham_(footballer)	wikicat_Darlington_F.C._players	176	70	106	1.5142857142857142
Olympique_Lyonnais	wikicat_G-14_clubs	5	2	3	1.5
Raoul_Bott	wikicat_Algebraic_geometers	10	4	6	1.5
Mario_Regueiro	wikicat_Primera_División_Argentina_players	5	2	3	1.5
Victor_Weisskopf	wikicat_Guggenheim_Fellows	10	4	6	1.5
Kassel	wikicat_Districts_of_Hesse	5	2	3	1.5
Aleksandar_Bajevski	wikicat_Macedonian_footballers	5	2	3	1.5
Itay_Shechter	wikicat_Israeli_expatriate_footballers	5	2	3	1.5
Walter_Novellino	wikicat_21st-century_Italian_people	5	2	3	1.5
Meryl_Streep	wikicat_Actors_from_New_Jersey	5	2	3	1.5
Aleksandar_Aleksandrov_(footballer_born_1975)	wikicat_PFC_Botev_Plovdiv_players	10	4	6	1.5
Aurelio_Vidmar	wikicat_Adelaide_City_players	20	8	12	1.5
American_Samoa	wordnet_country_108544813	5	2	3	1.5
Sheffield	wikicat_Cities_in_England	5	2	3	1.5
Poznań_County	wikicat_Land_counties_of_Greater_Poland_Voivodeship	5	2	3	1.5
Young_Artist_Award	wikicat_American_film_awards	10	4	6	1.5
Jim_Kerr_(footballer_born_1959)	wikicat_Partick_Thistle_F.C._players	5	2	3	1.5
Radosław_Kałużny	wikicat_Bayer_04_Leverkusen_players	5	2	3	1.5
David_Watson_(footballer_born_1946)	wikicat_England_international_footballers	80	32	48	1.5
Pierce_Brosnan	wikicat_21st-century_American_male_actors	15	6	9	1.5
Chris_Coyne	wikicat_Australia_international_soccer_players	10	4	6	1.5
S.S._Lazio	wikicat_Companies_listed_on_the_Borsa_Italiana	15	6	9	1.5
Cristiano_da_Silva_Santos	wikicat_Joinville_Esporte_Clube_players	20	8	12	1.5
Iván_Obolo	wikicat_Expatriate_footballers_in_Italy	5	2	3	1.5
Jim_Kerr_(footballer_born_1959)	wikicat_Hamilton_Academical_F.C._players	5	2	3	1.5
Macau	wikicat_Cities_in_China	5	2	3	1.5
College_Park,_Maryland	wikicat_Cities_in_Prince_George's_County,_Maryland	15179	6076	9103	1.498189598420013
Nozomi_Hiroyama	wikicat_Japanese_expatriates_in_France	214	86	128	1.4883720930232558
Romeo_Filipović	wikicat_MSV_Duisburg_players	92	37	55	1.4864864864864864
Gary_Sweet	wikicat_Australian_male_singers	154	62	92	1.4838709677419355
Ton_Pentre_F.C.	wikicat_Association_football_clubs_established_in_1935	15136	6101	9035	1.4809047697098836
Stevenage	wikicat_Towns_with_cathedrals_in_the_United_Kingdom	131	53	78	1.471698113207547
Marcus_Miller	wikicat_American_jazz_guitarists	284	115	169	1.4695652173913043
Tom_Stoppard	wikicat_Living_people	27	11	16	1.4545454545454546
José_Saramago	wikicat_Anti-globalization_activists	6178	2519	3659	1.4525605398967845
Mike_Ambersley	wikicat_North_American_Soccer_League_players	854	350	504	1.44
Wim_Suurbier	wikicat_FC_Schalke_04_players	90	37	53	1.4324324324324325
Jacques_Derrida	wikicat_French_people_of_Algerian_descent	17	7	10	1.4285714285714286
Frank_Sinatra	wikicat_Actors_from_New_Jersey	119	49	70	1.4285714285714286
Union_for_a_Popular_Movement	wikicat_Right-wing_parties	17	7	10	1.4285714285714286
Mauro_Sérgio_Viriato_Mendes	wikicat_Grêmio_Barueri_Futebol_players	298	123	175	1.4227642276422765
Thomas_Mulcair	wikicat_Anglophone_Quebec_people	92	38	54	1.4210526315789473
Diogo_Lézico_da_Silva	wikicat_Portimonense_S.C._players	46	19	27	1.4210526315789473
Lithuania	wikicat_States_and_territories_established_in_1990	179	74	105	1.4189189189189189
Dario_Dabac	wikicat_Expatriate_footballers_in_Kuwait	1401	582	819	1.407216494845361
Robert_Enke	wikicat_FC_Barcelona_footballers	12	5	7	1.4
Great_Turkish_War	wikicat_Wars_involving_Austria	12	5	7	1.4
Ramesh_Aravind	wikicat_Male_actors_in_Tamil_cinema	12	5	7	1.4
Stéphane_Zubar	wikicat_French_footballers	362	151	211	1.3973509933774835
Stock_Aitken_Waterman	wikicat_Songwriters	115	48	67	1.3958333333333333
Vietnam_War	wikicat_Wars_involving_New_Zealand	31	13	18	1.3846153846153846
Rod_Brown	wikicat_American_expatriate_basketball_people_in_Switzerland	319	134	185	1.3805970149253732
Robert_Enke	wikicat_UEFA_Euro_2008_players	69	29	40	1.3793103448275863
Ghana_national_under-17_football_team	wordnet_football_team_108080025	19	8	11	1.375
Paul_Krugman	wikicat_American_non-fiction_writers	253	107	146	1.3644859813084111
Armageddon_(1998_film)	wikicat_American_science_fiction_action_films	215	91	124	1.3626373626373627
Johnny_Torres	wikicat_Miami_Fusion_F.C._players	127	54	73	1.3518518518518519
Ioan_Sabău	wikicat_CFM_U_Cluj_managers	195	83	112	1.3493975903614457
Zambia_national_football_team	wordnet_football_team_108080025	82	35	47	1.3428571428571427
Kamil_Čontofalský	wikicat_Footballers_at_the_2000_Summer_Olympics	993	425	568	1.336470588235294
Mercedes_Lackey	wikicat_Fantasy_writers	7	3	4	1.3333333333333333
Holger_Fach	wikicat_2._Bundesliga_managers	7	3	4	1.3333333333333333
Madeleine_Carroll	wikicat_English_actresses	7	3	4	1.3333333333333333
Kim_Nam-il	wikicat_2002_FIFA_World_Cup_players	7	3	4	1.3333333333333333
Saskatoon_Blades	wikicat_Ice_hockey_teams_in_Canada	7	3	4	1.3333333333333333
San_Lorenzo_de_Almagro	wikicat_Football_clubs_in_Buenos_Aires	7	3	4	1.3333333333333333
Andy_Millen	wikicat_Hibernian_F.C._players	84	36	48	1.3333333333333333
Wolfgang_Pauli	wikicat_American_academics	21	9	12	1.3333333333333333
Rodney_Bush	wikicat_Scottish_Football_League_players	49	21	28	1.3333333333333333
Stephen_Fry	wikicat_English_voice_actors	28	12	16	1.3333333333333333
Rudolf_Peierls	wikicat_Ethnic_German_people	7	3	4	1.3333333333333333
Sander_Westerveld	wikicat_Real_Sociedad_footballers	963	414	549	1.326086956521739
Dennis_Rodman	wikicat_Actors_from_New_Jersey	58	25	33	1.32
Richmond_Boakye	wikicat_Elche_CF_players	464	200	264	1.32
Itay_Shechter	wikicat_1._FC_Kaiserslautern_players	327	141	186	1.3191489361702127
Hrishikesh_Mukherjee	wikicat_People_from_West_Bengal	30	13	17	1.3076923076923077
San_Francisco_Seals_(soccer)	wikicat_California_soccer_teams	3198	1390	1808	1.3007194244604317
Brazil	wikicat_Romance_countries_and_territories	46	20	26	1.3
Iván_Guerrero	wikicat_North_American_Soccer_League_players	207	90	117	1.3
Odense_Boldklub	wikicat_Badminton_clubs	779	339	440	1.2979351032448379
Fisher_Athletic_F.C.	wikicat_Association_football_clubs_established_in_1908	259	113	146	1.2920353982300885
Keanu_Reeves	wikicat_Canadian_film_producers	103	45	58	1.288888888888889
Bartoloměj_Kuru	wikicat_Expatriate_footballers_in_Slovakia	32	14	18	1.2857142857142858
A.F.C._Hornchurch	wikicat_Football_clubs_in_England	2810	1232	1578	1.280844155844156
Viborg_HK	wordnet_club_108227214	1589	697	892	1.2797704447632712
Luxembourg	wikicat_States_and_territories_established_in_1815	797	351	446	1.2706552706552707
Scott_Cooksey	wikicat_England_semi-pro_international_footballers	152	67	85	1.2686567164179106
INXS	wikicat_Musical_groups_established_in_1977	86	38	48	1.263157894736842
Marcos_Denner	wikicat_Paulista_Futebol_Clube_players	86	38	48	1.263157894736842
François_Remetter	wikicat_France_international_footballers	104	46	58	1.2608695652173914
Ezequiel_Lavezzi	wikicat_Argentine_people_of_Italian_descent	9	4	5	1.25
Olivier_Martinez	wikicat_French_male_film_actors	9	4	5	1.25
Nathan_Abbey	wikicat_Stevenage_F.C._players	9	4	5	1.25
Mississippi_River	wikicat_Rivers_of_the_United_States	9	4	5	1.25
Gdynia	wikicat_Port_cities_and_towns_in_Poland	9	4	5	1.25
Simon_Donaldson	wikicat_British_mathematicians	9	4	5	1.25
Pedro_Oliveira_(footballer)	wikicat_Portuguese_expatriates_in_Italy	702	313	389	1.2428115015974441
Dorin_Goian	wikicat_U.S._Città_di_Palermo_players	278	124	154	1.2419354838709677
Giuliano_Tadeo_Aranda	wikicat_Botafogo_de_Futebol_e_Regatas_players	38	17	21	1.2352941176470589
Sander_Westerveld	wikicat_UEFA_Euro_2004_players	105	47	58	1.2340425531914894
Michael_Duberry	wikicat_Reading_F.C._players	187	84	103	1.2261904761904763
Delta_Goodrem	wikicat_21st-century_Australian_actresses	69	31	38	1.2258064516129032
Carl_Friedrich_Gauss	wikicat_Statisticians	2463	1107	1356	1.2249322493224932
Adán_Vergara	wikicat_Expatriate_footballers_in_Brazil	80	36	44	1.2222222222222223
Paulus_Roiha	wikicat_FC_Honka_players	100	45	55	1.2222222222222223
Harry_B._Gray	wikicat_20th-century_chemists	155	70	85	1.2142857142857142
Maggie_Gyllenhaal	wikicat_American_anti–Iraq_War_activists	2723	1237	1486	1.2012934518997576
Nicaraguan_Revolution	wikicat_Guerrilla_wars	11	5	6	1.2
Marques_Houston	wikicat_American_male_singers	11	5	6	1.2
Cebu	wordnet_administrative_district_108491826	22	10	12	1.2
Daryl_Taylor	wikicat_Walsall_F.C._players	44	20	24	1.2
Millonarios_Fútbol_Club	wikicat_Football_clubs_in_Colombia	33	15	18	1.2
Cat_Power	wikicat_American_pianists	1531	696	835	1.1997126436781609
Christopher_Reeve	wikicat_American_writers	134	61	73	1.1967213114754098
CE_Sabadell_FC	wikicat_Association_football_clubs_established_in_1903	817	372	445	1.196236559139785
Andrea_Cocco	wikicat_A.C._Pistoiese_players	329	150	179	1.1933333333333334
Jeff_Minton	wikicat_Chelmsford_City_F.C._players	263	120	143	1.1916666666666667
Midge_Ure	wikicat_English_record_producers	201	92	109	1.184782608695652
Carlos_Casartelli	wikicat_Indios_de_Ciudad_Juárez_footballers	214	98	116	1.183673469387755
Cornwall	wikicat_Peninsulas_of_Europe	24	11	13	1.1818181818181819
Carlos_Navarro_Montoya	wikicat_CF_Extremadura_footballers	24	11	13	1.1818181818181819
Cape_Town	wikicat_Port_cities	13	6	7	1.1666666666666667
Mircea_Eliade	wikicat_Romanian_philosophers	13	6	7	1.1666666666666667
Kuujjuaq_Airport	wordnet_airport_102692232	132	61	71	1.1639344262295082
Daniele_De_Vezze	wikicat_Italy_youth_international_footballers	121	56	65	1.1607142857142858
Nemanja_Pejčinović	wikicat_FC_Lokomotiv_Moscow_players	315	146	169	1.1575342465753424
Éder_Aleixo_de_Assis	wikicat_1983_Copa_América_players	1085	504	581	1.1527777777777777
Alice_Munro	wikicat_Writers_from_Ontario	1628	758	870	1.1477572559366755
Peter_Sarsgaard	wikicat_People_from_St._Clair_County,_Illinois	388	181	207	1.143646408839779
Bogdan_Vrăjitoarea	wikicat_CS_Mioveni_players	15	7	8	1.1428571428571428
Ilian_Iliev	wikicat_PFC_Spartak_Varna_players	15	7	8	1.1428571428571428
Jean-Paul_Sartre	wikicat_Autobiographers	2043	956	1087	1.137029288702929
Amintore_Fanfani	wikicat_Presidents_of_the_Italian_Senate	94	44	50	1.1363636363636365
Subrahmanyan_Chandrasekhar	wikicat_American_astronomers	948	444	504	1.135135135135135
Roberto_Benigni	wikicat_Italian_stage_actors	17	8	9	1.125
A.F.C._Hornchurch	wikicat_Football_clubs_in_London	839	395	444	1.1240506329113924
Ikechi_Anya	wikicat_Northampton_Town_F.C._players	361	170	191	1.1235294117647059
John_Fraser_(footballer_born_1876)	wikicat_Motherwell_F.C._players	286	135	151	1.1185185185185185
Joshua_Jackson	wikicat_American_comics_writers	12632	5969	6663	1.1162673814709332
CS_Sedan_Ardennes	wikicat_Football_clubs_in_France	55	26	29	1.1153846153846154
San_Antonio	wikicat_County_seats_in_Texas	19	9	10	1.1111111111111112
Jimmy_Carter	wikicat_Sons_of_the_American_Revolution	276	131	145	1.1068702290076335
Omusati_Region	wikicat_Subdivisions_of_Namibia	16483	7825	8658	1.1064536741214057
G._K._Chesterton	wikicat_Converts_to_Roman_Catholicism_from_Anglicanism	10290	4888	5402	1.1051554828150574
Jamil_Fearrington	wordnet_artist_109812338	1509	717	792	1.104602510460251
Konstanz	wikicat_Borders_of_Germany	9335	4436	4899	1.1043733092876464
Le_Havre_AC	wordnet_club_108227214	404	192	212	1.1041666666666667
Denis_Leary	wordnet_comedian_109940146	21	10	11	1.1
Osamu_Tezuka	wikicat_Anime_screenwriters	21	10	11	1.1
Stephen_Dorff	wikicat_American_people_of_Jewish_descent	287	137	150	1.094890510948905
Matt_Carmichael_(footballer)	wikicat_Lincoln_City_F.C._players	23	11	12	1.0909090909090908
Keijo_Huusko	wikicat_Tromsø_IL_players	1132	542	590	1.088560885608856
Sigmund_Freud	wikicat_Austrian_atheists	25	12	13	1.0833333333333333
Sigmund_Freud	wikicat_Medical_writers	1361	655	706	1.0778625954198473
Glen_Moss	wikicat_FC_Dinamo_București_players	10889	5242	5647	1.0772605875619992
Jack_Reynolds_(footballer_born_1881)	wikicat_AFC_Ajax_managers	27	13	14	1.0769230769230769
George_Abbott	wikicat_Harvard_University_alumni	162	78	84	1.0769230769230769
Aarón_Ñíguez	wikicat_Recreativo_de_Huelva_footballers	110	53	57	1.0754716981132075
Gary_Moore	wikicat_British_people	87	42	45	1.0714285714285714
Cédric_Roussel	wikicat_Expatriate_footballers_in_Italy	29	14	15	1.0714285714285714
Miranda_Cooper	wikicat_British_female_singers	1973	954	1019	1.0681341719077568
Collins_John	wikicat_Pittsburgh_Riverhounds_players	347	168	179	1.0654761904761905
Éder_Aleixo_de_Assis	wikicat_Clube_Atlético_Paranaense_players	64	31	33	1.064516129032258
Bernardo_Tengarrinha	wikicat_C.D._Santa_Clara_players	33	16	17	1.0625
Steven_Spielberg	wikicat_Distinguished_Eagle_Scouts	7116	3457	3659	1.0584321666184553
Elmore_Leonard	wikicat_Writers_from_Detroit,_Michigan	1639	798	841	1.0538847117794485
Kafoumba_Coulibaly	wikicat_Chonburi_F.C._players	738	360	378	1.05
K.S.K._Beveren	wikicat_Association_football_clubs_established_in_1934	123	60	63	1.05
Santiago_Raymonda	wikicat_Quilmes_footballers	336	164	172	1.048780487804878
Modeste_M'bami	wikicat_Footballers_at_the_2000_Summer_Olympics	298	146	152	1.0410958904109588
Dorinel_Munteanu	wikicat_Romanian_expatriates_in_Belgium	100	49	51	1.0408163265306123
Micky_Adams	wikicat_Southampton_F.C._players	55	27	28	1.037037037037037
Vital_Lyadzyanyow	wikicat_Expatriate_footballers_in_Moldova	79	39	40	1.0256410256410255
Meryl_Streep	wikicat_Vassar_College_alumni	3115	1545	1570	1.0161812297734627
Joel_Soto	wikicat_Deportes_Concepción_footballers	2407	1200	1207	1.0058333333333334
Subrahmanyan_Chandrasekhar	wikicat_20th-century_astronomers	806	402	404	1.0049751243781095
Leicester	wordnet_site_108651247	4	2	2	1.0
AS_Saint-Étienne	wordnet_club_108227214	2	1	1	1.0
Carlos_Gamarra	wikicat_2002_FIFA_World_Cup_players	2	1	1	1.0
Chris_Coyne	wikicat_Perth_Glory_FC_players	4	2	2	1.0
Robert_Rodriguez	wikicat_American_film_producers	4	2	2	1.0
Alfred_Hörtnagl	wikicat_Austria_international_footballers	4	2	2	1.0
Collins_John	wikicat_Expatriate_footballers_in_England	4	2	2	1.0
Qingdao	wikicat_Sub-provincial_cities_in_the_People's_Republic_of_China	2	1	1	1.0
Vlatko_Marković	wikicat_GNK_Dinamo_Zagreb_managers	4	2	2	1.0
Diego_Perrone	wikicat_Uruguayan_footballers	4	2	2	1.0
Ravenna_F.C.	wikicat_Serie_B_clubs	2	1	1	1.0
Amartya_Sen	wordnet_economist_110043643	4	2	2	1.0
Ajax_Cape_Town_F.C.	wikicat_Premier_Soccer_League_clubs	4	2	2	1.0
Andriy_Kruhlyak	wikicat_Living_people	2	1	1	1.0
Allan_Nielsen	wikicat_Herfølge_Boldklub_players	2	1	1	1.0
Luxembourg	wikicat_Germanic_countries_and_territories	2	1	1	1.0
Rosemary_Clooney	wikicat_People_from_Los_Angeles,_California	4	2	2	1.0
Edinburgh_Airport	wordnet_airport_102692232	2	1	1	1.0
Asrani	wikicat_Indian_film_directors	2	1	1	1.0
Dorin_Goian	wikicat_Expatriate_footballers_in_Greece	2	1	1	1.0
Živan_Ljukovčan	wikicat_Association_football_goalkeepers_who_have_scored	4	2	2	1.0
Julio_Bevacqua	wikicat_Expatriate_footballers_in_Greece	2	1	1	1.0
Bănel_Nicoliță	wikicat_Expatriate_footballers_in_France	4	2	2	1.0
Victoria_(British_Columbia)	wikicat_Populated_coastal_places_in_Canada	2	1	1	1.0
Paul_Dickov	wikicat_Scottish_footballers	2	1	1	1.0
Málaga	wordnet_administrative_district_108491826	2	1	1	1.0
Robert_Silverberg	wikicat_American_writers	2	1	1	1.0
Sandro_Calabro	wikicat_Eredivisie_players	2	1	1	1.0
Lionel_Jospin	wikicat_French_socialists	4	2	2	1.0
Hòa_Bình_Province	wikicat_Provinces_of_Vietnam	4	2	2	1.0
Džoni_Novak	wikicat_Expatriate_footballers_in_France	4	2	2	1.0
San_Pablo_Airport	wikicat_Airports_in_Europe	4	2	2	1.0
Brooke_Shields	wikicat_21st-century_actors	2	1	1	1.0
F.C._Barreirense	wikicat_Football_clubs_in_Portugal	2	1	1	1.0
Barack_Obama	wikicat_Nobel_Peace_Prize_laureates	2	1	1	1.0
Tanya_Tucker	wordnet_artist_109812338	2	1	1	1.0
South_Carolina	wikicat_States_of_the_Confederate_States_of_America	2	1	1	1.0
Kim_Nam-il	wikicat_Expatriate_footballers_in_Japan	2	1	1	1.0
Golden_Globe_Award	wikicat_American_television_awards	2	1	1	1.0
Udinese_Calcio	wikicat_Football_clubs_in_Italy	2	1	1	1.0
Gerard_Butler	wikicat_British_people	2	1	1	1.0
Fritz_Lang	wikicat_American_screenwriters	2	1	1	1.0
Emeryville,_California	wikicat_Incorporated_cities_and_towns_in_California	2	1	1	1.0
Émile_Mpenza	wikicat_Swiss_Super_League_players	4	2	2	1.0
Faith_Evans	wikicat_American_singers	2	1	1	1.0
Marcinho_Guerreiro	wikicat_Goiás_Esporte_Clube_players	2	1	1	1.0
Northern_Region,_Ghana	wikicat_Regions_of_Ghana	2	1	1	1.0
Viggo_Mortensen	wikicat_People_from_New_York_City	2	1	1	1.0
Louis_XV_of_France	wikicat_French_people	2	1	1	1.0
Nainital_district	wikicat_Districts_of_Uttarakhand	2	1	1	1.0
Geelong	wikicat_Towns_in_Victoria_(Australia)	2	1	1	1.0
Alojz_Rebula	wikicat_Slovenian_dramatists_and_playwrights	2	1	1	1.0
Wydad_Casablanca	wikicat_Football_clubs_in_Morocco	2	1	1	1.0
Subrahmanyan_Chandrasekhar	wikicat_20th-century_mathematicians	2	1	1	1.0
Akaki_Devadze	wikicat_Georgia_(country)_international_footballers	2	1	1	1.0
Richmond_Boakye	wikicat_People_from_Accra	2	1	1	1.0
FC_Steaua_București	wikicat_Liga_I_clubs	2	1	1	1.0
Brisbane_Roar_FC	wordnet_club_108227214	2	1	1	1.0
Terence_McKenna	wikicat_20th-century_American_writers	2	1	1	1.0
Keanu_Reeves	wikicat_Canadian_people_of_Irish_descent	2	1	1	1.0
Hilary_Duff	wikicat_21st-century_American_actresses	2	1	1	1.0
William_Golding	wikicat_British_writers	2	1	1	1.0
Dublin	wikicat_County_towns_in_the_Republic_of_Ireland	2	1	1	1.0
Italian_Campaign_(World_War_II)	wordnet_conflict_100958896	2	1	1	1.0
Suwałki_County	wikicat_Land_counties_of_Podlaskie_Voivodeship	2	1	1	1.0
Panhellenic_Socialist_Movement	wikicat_Social_democratic_parties	2	1	1	1.0
Veghel	wikicat_Cities_in_the_Netherlands	2	1	1	1.0
Tony_Bennett	wikicat_American_singers	2	1	1	1.0
Nobles_County,_Minnesota	wordnet_county_108546183	2	1	1	1.0
Ernest_Rutherford	wikicat_20th-century_physicists	2	1	1	1.0
Tommy_Gaynor	wikicat_Cork_City_F.C._players	2	1	1	1.0
Dorin_Goian	wikicat_Romanian_footballers	2	1	1	1.0
Damián_Manso	wikicat_Expatriate_footballers_in_Mexico	2	1	1	1.0
Luis_García_(footballer,_born_1978)	wikicat_Spain_international_footballers	10	5	5	1.0
Kjetil_Wæhler	wikicat_Norwegian_footballers	2	1	1	1.0
Steven_Weinberg	wikicat_Jewish_physicists	2	1	1	1.0
Kerala_State_Film_Award	wikicat_Indian_film_awards	10	5	5	1.0
A.S.G._Nocerina	wikicat_Lega_Pro_Prima_Divisione_clubs	2	1	1	1.0
Roger_Glover	wikicat_British_composers	26	13	13	1.0
University_of_Rhode_Island	wikicat_Flagship_universities_in_the_United_States	2	1	1	1.0
Tam_McManus	wikicat_Scottish_Premier_League_players	2	1	1	1.0
Emeryville,_California	wordnet_administrative_district_108491826	2	1	1	1.0
Alicia_Silverstone	wikicat_American_television_actors	2	1	1	1.0
Jared_Borgetti	wikicat_C.F._Pachuca_footballers	2	1	1	1.0
Reinaldo_da_Cruz_Oliveira	wikicat_Suwon_Samsung_Bluewings_players	6	3	3	1.0
Charleston_Battery	wikicat_Soccer_clubs_in_the_United_States	2	1	1	1.0
Kathy_Bates	wikicat_20th-century_actresses	2	1	1	1.0
László_Klausz	wikicat_Hungarian_footballers	2	1	1	1.0
Marburg	wikicat_University_towns_in_Germany	2	1	1	1.0
Frances_Goodrich	wikicat_American_people	2	1	1	1.0
Nicaragua	wikicat_States_and_territories_established_in_1821	2	1	1	1.0
Bernie_Mac	wikicat_American_people	2	1	1	1.0
Kuwait_City	wikicat_Port_cities_and_towns_of_the_Persian_Gulf	8	4	4	1.0
Sport_Boys	wordnet_club_108227214	2	1	1	1.0
Amy_Adams	wikicat_21st-century_American_actresses	2	1	1	1.0
Julianne_Moore	wikicat_21st-century_American_actresses	2	1	1	1.0
Matthew_Broderick	wikicat_21st-century_American_actors	2	1	1	1.0
Alex_Bruce_(footballer,_born_1984)	wikicat_Premier_League_players	2	1	1	1.0
Châtenay-Malabry	wikicat_Communes_of_Hauts-de-Seine	2	1	1	1.0
Kiki_Musampa	wikicat_Ligue_1_players	2	1	1	1.0
Kosovo	wordnet_country_108544813	2	1	1	1.0
Montrouge	wikicat_Communes_of_Hauts-de-Seine	2	1	1	1.0
Szczecin	wikicat_Port_cities	2	1	1	1.0
Sergey_Timofeev	wikicat_Kazakhstani_footballers	2	1	1	1.0
Kingdom_of_Bavaria	wikicat_States_of_the_German_Confederation	2	1	1	1.0
Gene_Kelly	wikicat_American_male_film_actors	2	1	1	1.0
Milan_Purović	wikicat_Ukrainian_Premier_League_players	2	1	1	1.0
Dumitru_Mitu	wikicat_Expatriate_footballers_in_Greece	2	1	1	1.0
Elmore_Leonard	wikicat_American_mystery_writers	2	1	1	1.0
Madeleine_Carroll	wikicat_English_film_actresses	2	1	1	1.0
Southampton_F.C.	wikicat_Football_League_Championship_clubs	8	4	4	1.0
Baie-Comeau	wikicat_Cities_and_towns_in_Quebec	2	1	1	1.0
Srgjan_Zaharievski	wikicat_Macedonian_expatriate_footballers	2	1	1	1.0
Kamel_Larbi	wikicat_Ligue_1_players	2	1	1	1.0
Silviu_Izvoranu	wikicat_Romanian_footballers	2	1	1	1.0
C._S._Lewis	wikicat_English-language_writers	2	1	1	1.0
Bozhidar_Iskrenov	wikicat_People_from_Sofia	2	1	1	1.0
IF_Björklöven	wikicat_Ice_hockey_teams_in_Sweden	6	3	3	1.0
Fernando_Varela_Ramos	wikicat_Spanish_footballers	2	1	1	1.0
Ricky_Gervais	wikicat_Actors	2	1	1	1.0
Margaret_Sullavan	wikicat_Actors	2	1	1	1.0
University_of_San_Francisco	wikicat_Schools_accredited_by_the_Western_Association_of_Schools_and_Colleges	2	1	1	1.0
Saul_Kripke	wikicat_Analytic_philosophers	2	1	1	1.0
University_of_Adelaide	wikicat_Universities_in_Australia	2	1	1	1.0
Bellshill	wikicat_Towns_in_North_Lanarkshire	2	1	1	1.0
Sivaji_Ganesan	wikicat_Actors	2	1	1	1.0
Wismar	wordnet_location_100027167	2	1	1	1.0
Branco_(footballer)	wikicat_Brazil_international_footballers	2	1	1	1.0
Eduardo_Carvalho	wikicat_Portuguese_expatriates_in_Turkey	22	11	11	1.0
Ger_Rowe	wikicat_Ballymena_United_F.C._players	2	1	1	1.0
Johnstown_Chiefs	wordnet_team_108208560	2	1	1	1.0
Yale_Law_School	wikicat_Law_schools	2	1	1	1.0
Bernard_Cornwell	wikicat_English_writers	2	1	1	1.0
Maurice_Ross	wikicat_Scottish_footballers	2	1	1	1.0
Central_Coast_Mariners_FC	wikicat_A-League_teams	36	18	18	1.0
Kamil_Čontofalský	wikicat_Slovak_First_League_players	2	1	1	1.0
Nano_(Spanish_footballer_born_1980)	wikicat_Spanish_people	18	9	9	1.0
Falkirk	wikicat_Cities_in_Scotland	8	4	4	1.0
French_language	wikicat_Languages_of_Lebanon	8	4	4	1.0
Billy_Corgan	wikicat_Songwriters	26	13	13	1.0
Upton_Sinclair	wikicat_American_male_writers	28	14	14	1.0
Daphne_du_Maurier	wikicat_British_historical_novelists	2	1	1	1.0
Fredrik_Björck	wikicat_AIK_Fotboll_players	10	5	5	1.0
Ion_Vélez	wikicat_CD_Numancia_players	2	1	1	1.0
Pakistan_Muslim_League_(N)	wikicat_Liberal_parties	2	1	1	1.0
Mark_Prudhoe	wikicat_Sunderland_A.F.C._players	56	28	28	1.0
Rivaldo_Barbosa_de_Souza	wikicat_Santos_Futebol_Clube_players	2	1	1	1.0
Valdas_Ivanauskas	wikicat_Soviet_footballers	30	15	15	1.0
Club_Atlético_Vélez_Sarsfield	wikicat_Multi-sport_clubs_in_Argentina	2	1	1	1.0
Olivier_Martinez	wikicat_Male_actors_from_Paris	8	4	4	1.0
Gianfranco_Labarthe	wikicat_Torneo_Descentralizado_footballers	10	5	5	1.0
John_Maynard_Keynes	wordnet_economist_110043643	6	3	3	1.0
Marcinho_Guerreiro	wikicat_Campeonato_Brasileiro_Série_A_footballers	8	4	4	1.0
Leominster,_Massachusetts	wikicat_Cities_in_Worcester_County,_Massachusetts	24	12	12	1.0
Stuart_Green	wikicat_Carlisle_United_F.C._players	20	10	10	1.0
Aleš_Pikl	wikicat_Czech_Republic_under-21_international_footballers	8	4	4	1.0
Hannah-Beth_Jackson	wikicat_Living_people	8	4	4	1.0
Augsburg	wordnet_country_108544813	8	4	4	1.0
Freeman_Dyson	wikicat_Science_writers	8	4	4	1.0
Gabon	wikicat_States_and_territories_established_in_1960	12	6	6	1.0
Cornel_Dobre	wikicat_FC_Dinamo_București_players	6	3	3	1.0
George_R._R._Martin	wikicat_Worldcon_Guests_of_Honor	74	37	37	1.0
Gabriel_Urdaneta	wikicat_Venezuelan_footballers	6	3	3	1.0
Scott_Willis_(footballer)	wikicat_Leigh_Genesis_F.C._players	6	3	3	1.0
Dick_Van_Dyke	wikicat_American_male_voice_actors	14	7	7	1.0
Bob_Hope	wikicat_Comedians	6	3	3	1.0
Canada	wikicat_Member_states_of_the_Commonwealth_of_Nations	6	3	3	1.0
Lucky_Idahor	wikicat_Expatriate_footballers_in_Azerbaijan	12	6	6	1.0
Jennifer_Lopez	wikicat_American_voice_actors	6	3	3	1.0
Jorge_Costa	wikicat_Portuguese_expatriates_in_Cyprus	60	30	30	1.0
Jonathan_Lethem	wikicat_Writers_from_New_York	68	34	34	1.0
Steven_Weinberg	wikicat_Jewish_American_scientists	28	14	14	1.0
Erik_Edman	wikicat_Expatriate_footballers_in_Germany	6	3	3	1.0
John_Hartson	wikicat_Scottish_Premier_League_players	80	40	40	1.0
Nozomi_Hiroyama	wikicat_Expatriate_footballers_in_France	6	3	3	1.0
Hinsdale,_Illinois	wikicat_Villages_in_Illinois	6	3	3	1.0
Denis_Leary	wikicat_American_television_actors	6	3	3	1.0
Adam_Smith	wikicat_Scottish_people	18	9	9	1.0
Charles_de_Gaulle	wikicat_20th-century_French_politicians	6	3	3	1.0
Robin_Cook_(American_novelist)	wikicat_20th-century_writers	315	158	157	0.9936708860759493
Jerry_Siegel	wikicat_Disney_comics_artists	6634	3343	3291	0.9844451091833682
Nélson_Marcos	wikicat_UD_Almería_footballers	115	58	57	0.9827586206896551
Charles_K._Kao	wikicat_British_academics	103	52	51	0.9807692307692307
Aurelio_Vidmar	wikicat_1997_FIFA_Confederations_Cup_players	1621	826	795	0.9624697336561744
Jay_Mohr	wikicat_Male_actors_from_New_Jersey	51	26	25	0.9615384615384616
Neil_Wood	wikicat_Expatriate_footballers_in_Bosnia_and_Herzegovina	233	119	114	0.957983193277311
Leonid_Hurwicz	wikicat_American_mathematicians	99	51	48	0.9411764705882353
Nicola_Amoruso	wikicat_A.C._Perugia_Calcio_players	126	65	61	0.9384615384615385
Borussia_Dortmund	wikicat_Publicly_traded_sports_companies	29	15	14	0.9333333333333333
Emmet_Friars	wikicat_A.F.C._Telford_United_players	58	30	28	0.9333333333333333
Kochi	wikicat_Cities_and_towns_in_Kerala	29	15	14	0.9333333333333333
Gheorghe_Hagi	wikicat_Real_Madrid_C.F._players	517	268	249	0.9291044776119403
Lee_Johnson_(footballer)	wikicat_Chesterfield_F.C._players	54	28	26	0.9285714285714286
David_García_Haro	wikicat_Cádiz_CF_footballers	79	41	38	0.926829268292683
Persebaya_Surabaya	wikicat_Football_clubs_in_Indonesia	6059	3145	2914	0.926550079491256
NK_Bravo1_Interblock	wikicat_Association_football_clubs_established_in_1975	3205	1665	1540	0.924924924924925
Phil_Charnock	wikicat_English_footballers	25	13	12	0.9230769230769231
Windhoek	wikicat_Regional_capitals_in_Namibia	15911	8295	7616	0.9181434599156119
June_Allyson	wikicat_Metro-Goldwyn-Mayer_contract_players	23	12	11	0.9166666666666666
FC_Chiasso	wordnet_club_108227214	6223	3247	2976	0.9165383430859255
Guilherme_de_Cássio_Alves	wikicat_Club_de_Regatas_Vasco_da_Gama_players	42	22	20	0.9090909090909091
George_Orwell	wikicat_English_political_writers	334	175	159	0.9085714285714286
Radosław_Kałużny	wikicat_Jagiellonia_Białystok_players	40	21	19	0.9047619047619048
Armand_Traoré	wikicat_France_under-21_international_footballers	19	10	9	0.9
Christian_Brand	wikicat_German_football_managers	19	10	9	0.9
Walt_Disney	wikicat_English-language_film_directors	36	19	17	0.8947368421052632
Iván_Obolo	wikicat_AIK_Fotboll_players	180	95	85	0.8947368421052632
Ioan_Sabău	wikicat_Feyenoord_players	157	83	74	0.891566265060241
Cobresal	wikicat_Football_clubs_in_Chile	13182	6977	6205	0.8893507238067937
The_Simpsons_Movie	wikicat_Animated_comedy_films	81	43	38	0.8837209302325582
Vince_Clarke	wikicat_People_from_Redbridge_(London_borough)	2469	1311	1158	0.8832951945080092
Ebrahim_Taghipour	wikicat_Esteghlal_F.C._players	2430	1291	1139	0.8822618125484121
George_Best	wikicat_Miami_FC_players	675	359	316	0.8802228412256268
Jack_Black	wikicat_Actors_from_California	77	41	36	0.8780487804878049
Aria_(film)	wikicat_German-language_films	291	155	136	0.8774193548387097
Nicolás_Diez	wikicat_Argentina_youth_international_footballers	291	155	136	0.8774193548387097
Gustavo_Napoles	wikicat_Tigres_UANL_footballers	321	171	150	0.8771929824561403
Portsmouth_F.C.	wikicat_Association_football_clubs_established_in_1898	437	233	204	0.8755364806866953
Jakarta	wordnet_administrative_district_108491826	15	8	7	0.875
Lyndon_B._Johnson	wikicat_Vice_Presidents_of_the_United_States	15	8	7	0.875
Debbie_Reynolds	wikicat_Actresses_from_Beverly_Hills,_California	150	80	70	0.875
David_Craig_(Scottish_footballer)	wikicat_Hamilton_Academical_F.C._players	15	8	7	0.875
Karl_Marx	wikicat_Sociologists	2814	1501	1313	0.8747501665556295
James_Wesolowski	wikicat_Leicester_City_F.C._players	116	62	54	0.8709677419354839
Neil_Lennon	wikicat_Crewe_Alexandra_F.C._players	155	83	72	0.8674698795180723
Caleb_Patterson-Sewell	wikicat_Carolina_RailHawks_players	80	43	37	0.8604651162790697
University_of_Minnesota	wikicat_Universities_and_colleges_in_Minnesota	17181	9242	7939	0.8590132006059295
Christopher_Hitchens	wikicat_English_non-fiction_writers	15285	8228	7057	0.8576810889645115
Mircea_Eliade	wikicat_Romanian_biographers	13	7	6	0.8571428571428571
FC_Obolon_Kyiv	wikicat_Defunct_football_clubs_in_Ukraine	13	7	6	0.8571428571428571
Ian_Thomas-Moore	wikicat_Burnley_F.C._players	128	69	59	0.855072463768116
Mitch_Hedberg	wikicat_American_people_of_Swedish_descent	1956	1055	901	0.8540284360189574
Ladislas_Douniama	wikicat_US_Orléans_players	443	240	203	0.8458333333333333
Natasha_Richardson	wikicat_Shakespearean_actors	164	89	75	0.8426966292134831
Austin,_Texas	wikicat_Planned_cities_in_the_United_States	35	19	16	0.8421052631578947
Gabri_García	wikicat_Olympic_silver_medalists_for_Spain	445	242	203	0.8388429752066116
Mark_Williams_(South_African_footballer)	wikicat_Xian_Chanba_players	5704	3111	2593	0.8334940533590486
Ibón_Gutiérrez	wikicat_CD_Basconia_footballers	11	6	5	0.8333333333333334
Max_Kruse	wikicat_Borussia_Mönchengladbach_players	55	30	25	0.8333333333333334
Dorinel_Munteanu	wikicat_FC_CFR_Cluj_managers	66	36	30	0.8333333333333334
Ricardo_Rocha_(Portuguese_footballer)	wikicat_S.C._Braga_players	11	6	5	0.8333333333333334
Kenneth_G._Wilson	wikicat_Living_people	55	30	25	0.8333333333333334
Vital_Lyadzyanyow	wikicat_FC_Inter_Baku_players	22	12	10	0.8333333333333334
Charlie_Chaplin	wikicat_British_artists	11	6	5	0.8333333333333334
Julianne_Moore	wikicat_People_from_North_Carolina	7124	3902	3222	0.8257303946694003
Richard_Rorty	wikicat_American_political_philosophers	1912	1048	864	0.8244274809160306
Maroš_Klimpl	wikicat_FK_Viktoria_Žižkov_players	20	11	9	0.8181818181818182
Cole_Porter	wikicat_LGBT_people	40	22	18	0.8181818181818182
Félix_Ricardo_Torres	wikicat_1987_Copa_América_players	234	129	105	0.813953488372093
Mike_Ambersley	wikicat_Minnesota_United_FC_players	1158	641	517	0.8065522620904836
Henri_Poincaré	wikicat_19th-century_physicists	121	67	54	0.8059701492537313
Deportivo_de_La_Coruña	wikicat_Galician_football_clubs	9	5	4	0.8
Caroline_Seger	wikicat_2011_FIFA_Women's_World_Cup_players	9	5	4	0.8
Søren_Larsen	wikicat_Denmark_under-21_international_footballers	9	5	4	0.8
Fernando_Varela_Ramos	wikicat_Real_Betis_footballers	9	5	4	0.8
Austria	wikicat_Federal_countries	27	15	12	0.8
Tarlan_Ahmadov	wikicat_PFK_Turan_players	9	5	4	0.8
John_Ireland_(actor)	wikicat_People_from_New_York_City	9	5	4	0.8
Genoa	wikicat_Roman_towns_and_cities_in_Italy	9	5	4	0.8
Les_plus_belles_escroqueries_du_monde	wikicat_Black-and-white_films	142	79	63	0.7974683544303798
George_Orwell	wikicat_English_essayists	34	19	15	0.7894736842105263
Éder_Aleixo_de_Assis	wikicat_Sociedade_Esportiva_do_Gama_players	25	14	11	0.7857142857142857
Indonesia	wikicat_Countries_in_Oceania	50	28	22	0.7857142857142857
Williams_Martínez	wikicat_West_Bromwich_Albion_F.C._players	625	350	275	0.7857142857142857
Somalia	wikicat_Federal_countries	25	14	11	0.7857142857142857
Oleksiy_Horodov	wikicat_FC_Spartak_Ivano-Frankivsk_players	328	184	144	0.782608695652174
Singapore	wikicat_Populated_coastal_places	4854	2727	2127	0.7799779977997799
Newport_County_A.F.C.	wordnet_club_108227214	16	9	7	0.7777777777777778
Rabiola	wikicat_C.D._Feirense_players	1996	1125	871	0.7742222222222223
Grêmio_Foot-Ball_Porto_Alegrense	wikicat_Association_football_clubs_established_in_1903	535	302	233	0.7715231788079471
Quito	wikicat_Populated_places_in_Ecuador	16167	9131	7036	0.7705618223633776
F.C._Hansa_Rostock	wikicat_Football_clubs_in_Mecklenburg-Vorpommern	17032	9622	7410	0.7701101642070256
FremantleMedia	wikicat_Companies_of_the_United_Kingdom	16691	9431	7260	0.7698017177393701
Carl_Sagan	wikicat_Jewish_American_scientists	23	13	10	0.7692307692307693
Henry_Fonda	wikicat_Kennedy_Center_honorees	76	43	33	0.7674418604651163
Flannery_O'Connor	wikicat_Women_writers	1144	648	496	0.7654320987654321
George_R._R._Martin	wikicat_American_bloggers	298	169	129	0.7633136094674556
Daniel_Handler	wikicat_Male_short_story_writers	67	38	29	0.7631578947368421
Leandro_Lourenço_Franco	wikicat_Atromitos_F.C._players	440	250	190	0.76
Eddie_Basden	wikicat_Chicago_Bulls_players	667	379	288	0.7598944591029023
Laurent_Fabius	wikicat_French_Ministers_of_Finance	7	4	3	0.75
Jean_Harlow	wikicat_20th-century_actors	7	4	3	0.75
Gloucester_City_A.F.C.	wikicat_Association_football_clubs_established_in_1883	42	24	18	0.75
John_Adams	wikicat_Vice_Presidents_of_the_United_States	14	8	6	0.75
Melissa_Tancredi	wikicat_National_Women's_Soccer_League_players	21	12	9	0.75
Carlos_Salazar_(Colombian_footballer)	wikicat_People_from_Cali	7	4	3	0.75
John_Ireland_(actor)	wikicat_American_television_actors	7	4	3	0.75
Émerson_Leão	wikicat_Brazil_international_footballers	7	4	3	0.75
Mattia_Biso	wikicat_Italian_footballers	7	4	3	0.75
Legion_of_Honour	wikicat_Military_orders	16416	9381	7035	0.7499200511672529
Marconi_Stallions_FC	wikicat_Association_football_clubs_established_in_1972	845	484	361	0.7458677685950413
Mort_Shuman	wikicat_People_from_Brooklyn	75	43	32	0.7441860465116279
Dominique_de_Villepin	wordnet_minister_110320863	54	31	23	0.7419354838709677
Aleksandre_Kobakhidze	wikicat_Association_football_wingers	908	522	386	0.7394636015325671
Henri_Fuchs	wikicat_1._FC_Köln_players	66	38	28	0.7368421052631579
Gyula_Lóránt	wikicat_Olympic_footballers_of_Hungary	13588	7826	5762	0.7362637362637363
I._M._Pei	wikicat_Chinese_people	26	15	11	0.7333333333333333
James_Tobin	wikicat_People_from_Champaign,_Illinois	12656	7302	5354	0.7332237743084087
Ebbw_Vale_F.C.	wordnet_club_108227214	19	11	8	0.7272727272727273
Midge_Ure	wikicat_Guitarists	19	11	8	0.7272727272727273
Franco-Prussian_War	wikicat_Conflicts_in_1870	95	55	40	0.7272727272727273
Frank_Arnesen	wikicat_Association_football_executives	3190	1847	1343	0.7271250676773146
Tom_Paxton	wikicat_People_from_Chicago,_Illinois	5179	2999	2180	0.7269089696565522
Ebbw_Vale_F.C.	wikicat_Association_football_clubs_disestablished_in_1998	6922	4009	2913	0.7266151159890247
Marcus_Vinícius_da_Cruz_Alves_Nóbrega	wikicat_Clube_Náutico_Capibaribe_players	50	29	21	0.7241379310344828
Foeke_Booy	wikicat_PEC_Zwolle_players	1028	597	431	0.7219430485762144
Rugby_Town_F.C.	wikicat_Football_clubs_in_England	79	46	33	0.717391304347826
Dyron_Nix	wikicat_American_expatriate_basketball_people_in_France	12	7	5	0.7142857142857143
Milan_Kundera	wikicat_French-language_writers	12	7	5	0.7142857142857143
Michael_Hughes_(footballer)	wikicat_West_Ham_United_F.C._players	24	14	10	0.7142857142857143
Paul_Konchesky	wikicat_Leicester_City_F.C._players	12	7	5	0.7142857142857143
Thom_Yorke	wikicat_British_composers	12	7	5	0.7142857142857143
Valéry_Giscard_d'Estaing	wikicat_Government_ministers_of_France	12	7	5	0.7142857142857143
Mark_Prudhoe	wikicat_Bradford_City_A.F.C._players	24	14	10	0.7142857142857143
Sir_Seewoosagur_Ramgoolam_International_Airport	wikicat_Airports_established_in_1942	36	21	15	0.7142857142857143
Inglourious_Basterds	wikicat_French-language_films	24	14	10	0.7142857142857143
Bernie_Lilavois	wikicat_Continental_Indoor_Soccer_League_players	53	31	22	0.7096774193548387
Nazi_Party	wikicat_Political_parties_disestablished_in_1945	13629	7975	5654	0.7089655172413794
André_Luiz_Moreira	wikicat_CD_Tenerife_players	343	201	142	0.7064676616915423
S.C._Freamunde	wikicat_Football_clubs_in_Portugal	162	95	67	0.7052631578947368
Andy_Gurney	wikicat_Torquay_United_F.C._players	46	27	19	0.7037037037037037
Ambika_(actress)	wordnet_person_100007846	17	10	7	0.7
Toronto	wikicat_Populated_coastal_places	561	330	231	0.7
George_Orwell	wikicat_War_correspondents	248	146	102	0.6986301369863014
Aurelio_Vidmar	wikicat_Croydon_Kings_players	15357	9042	6315	0.6984074319840743
Stuart_Fleetwood	wikicat_Eastleigh_F.C._players	258	152	106	0.6973684210526315
Robert_Jarni	wikicat_UEFA_Euro_1996_players	39	23	16	0.6956521739130435
Andrija_Kaluđerović	wikicat_Serbian_expatriates_in_China	208	123	85	0.6910569105691057
Jack_Ross_(footballer_born_1976)	wikicat_St._Mirren_F.C._players	32	19	13	0.6842105263157895
Yuri_Morales	wikicat_Viborg_FF_players	5504	3272	2232	0.6821515892420538
Gheorghe_Hagi	wikicat_FC_Steaua_București_managers	148	88	60	0.6818181818181818
Agustín_Castillo	wikicat_Expatriate_footballers_in_Ecuador	47	28	19	0.6785714285714286
Georges_Simenon	wikicat_People_from_Liège_(city)	15759	9395	6364	0.6773815859499734
Woodrow_Wilson	wikicat_State_governors_of_the_United_States	258	154	104	0.6753246753246753
Pittsburgh_International_Airport	wikicat_Airfields_of_the_United_States_Army_Air_Forces_in_Pennsylvania	14535	8678	5857	0.6749250979488362
Aldous_Huxley	wikicat_Writers_from_Los_Angeles,_California	3759	2246	1513	0.6736420302760463
Peggy_Lokando	wikicat_Waltham_Forest_F.C._players	15083	9023	6060	0.6716169788318741
Émile_Mpenza	wikicat_Hamburger_SV_players	5	3	2	0.6666666666666666
Nelson_Benítez	wikicat_Expatriate_footballers_in_Portugal	5	3	2	0.6666666666666666
Maurice_Blanchot	wordnet_writer_110794014	5	3	2	0.6666666666666666
C.A._River_Plate	wikicat_Multi-sport_clubs_in_Argentina	5	3	2	0.6666666666666666
Aritz_Aduriz	wikicat_Association_football_forwards	5	3	2	0.6666666666666666
Zoran_Milinković_(footballer)	wikicat_Serbian_football_managers	15	9	6	0.6666666666666666
Debbie_Reynolds	wikicat_American_people_of_English_descent	5	3	2	0.6666666666666666
Zoran_Milinković_(footballer)	wikicat_Bundesliga_players	25	15	10	0.6666666666666666
Christopher_Reeve	wikicat_Actors_from_New_York_City	5	3	2	0.6666666666666666
Thomas_Paine	wikicat_American_foreign_policy_writers	135	81	54	0.6666666666666666
Mauricio_Hanuch	wikicat_Estudiantes_de_La_Plata_footballers	5	3	2	0.6666666666666666
J._R._Reid	wikicat_Baloncesto_León_players	335	201	134	0.6666666666666666
Agnes_Moorehead	wikicat_American_people_of_Irish_descent	5	3	2	0.6666666666666666
David_Bohm	wikicat_Jewish_scientists	15	9	6	0.6666666666666666
Leoben_District	wikicat_Districts_of_Austria	5	3	2	0.6666666666666666
Marc_Anthony	wikicat_American_male_singers	5	3	2	0.6666666666666666
NK_Posušje	wordnet_club_108227214	5	3	2	0.6666666666666666
George_Santayana	wikicat_American_writers	5	3	2	0.6666666666666666
Kent_O'Connor	wikicat_Naturalized_citizens_of_Canada	10	6	4	0.6666666666666666
Order_of_the_Aztec_Eagle	wikicat_Civil_awards_and_decorations	5	3	2	0.6666666666666666
Wismar	wikicat_Populated_coastal_places_in_Germany_(Baltic_Sea)	5	3	2	0.6666666666666666
Sri_Lanka	wikicat_Member_states_of_the_South_Asian_Association_for_Regional_Cooperation	10	6	4	0.6666666666666666
Eau_Claire,_Wisconsin	wordnet_administrative_district_108491826	10	6	4	0.6666666666666666
Neil_Jordan	wikicat_Irish_writers	10	6	4	0.6666666666666666
Walt_Disney	wikicat_American_philanthropists	243	146	97	0.6643835616438356
Alexandre_Lopes	wikicat_Goiás_Esporte_Clube_players	78	47	31	0.6595744680851063
Francis_Bacon	wikicat_British_spies	16723	10079	6644	0.6591923801964481
Vanče_Šikov	wikicat_GFK_Tikveš_players	12276	7418	4858	0.6548935022917228
Liza_Minnelli	wikicat_Actresses_from_Los_Angeles,_California	43	26	17	0.6538461538461539
Frédéric_Nimani	wikicat_Premier_League_players	38	23	15	0.6521739130434783
José_Moisela	wikicat_Deportivo_Municipal_footballers	165	100	65	0.65
Michèle_Alliot-Marie	wikicat_People_from_Val-de-Marne	17466	10589	6877	0.6494475398998961
Stevenage	wikicat_Towns_in_Hertfordshire	28	17	11	0.6470588235294118
Boston	wikicat_Cities_in_Suffolk_County,_Massachusetts	13847	8411	5436	0.646296516466532
Ronald_Coase	wikicat_British_Nobel_laureates	23	14	9	0.6428571428571429
Peter_Kropotkin	wikicat_Soviet_dissidents	115	70	45	0.6428571428571429
Niš	wikicat_Archaeological_sites_in_Serbia	18	11	7	0.6363636363636364
Dougie_Bell	wikicat_Elgin_City_F.C._players	121	74	47	0.6351351351351351
Georges_Bataille	wikicat_Men_sociologists	67	41	26	0.6341463414634146
Captain_Beefheart	wikicat_Songwriters_from_California	227	139	88	0.6330935251798561
Mark_Williams_(South_African_footballer)	wikicat_Jomo_Cosmos_F.C._players	15579	9565	6014	0.6287506534239414
Harold_Urey	wikicat_20th-century_chemists	109	67	42	0.6268656716417911
Nicola_Amoruso	wikicat_A.S._Andria_BAT_players	247	152	95	0.625
Gustavo_Victoria	wikicat_Cortuluá_footballers	21	13	8	0.6153846153846154
David_Hilbert	wikicat_People_from_Königsberg	21	13	8	0.6153846153846154
Moscow	wikicat_Special_Economic_Zones	21	13	8	0.6153846153846154
Milan_Purović	wikicat_Expatriate_footballers_in_Hungary	21	13	8	0.6153846153846154
Silvio_González	wikicat_San_Lorenzo_footballers	42	26	16	0.6153846153846154
Andrey_Movsisyan	wikicat_FC_Luch-Energiya_Vladivostok_players	113	70	43	0.6142857142857143
Jeremy_Bentham	wikicat_Animal_rights_advocates	11494	7122	4372	0.6138725077225499
Gustavo_Biscayzacú	wikicat_Tiburones_Rojos_de_Veracruz_footballers	282	175	107	0.6114285714285714
Chad_Harpur	wikicat_Association_football_goalkeepers	29	18	11	0.6111111111111112
Nassim_Mendil	wikicat_U.S._Salernitana_1919_players	58	36	22	0.6111111111111112
Marijan_Kovačević	wikicat_Ethnic_German_people	127	79	48	0.6075949367088608
Congo_Crisis	wikicat_Wars_involving_Sweden	98	61	37	0.6065573770491803
Ronald_Arana	wikicat_1999_FIFA_Confederations_Cup_players	1208	752	456	0.6063829787234043
Jason_Blunt	wikicat_Guiseley_A.F.C._players	183	114	69	0.6052631578947368
David_Byrne	wikicat_British_record_producers	69	43	26	0.6046511627906976
Delta_Goodrem	wikicat_Australian_television_actresses	8	5	3	0.6
Burhan_Eşer	wikicat_Sivasspor_footballers	8	5	3	0.6
Nikolai_Olenikov	wikicat_Russian_footballers	8	5	3	0.6
Alfonso_Blanco_Antúnez	wikicat_Cruz_Azul_footballers	8	5	3	0.6
Delta_Goodrem	wikicat_Australian_film_actors	8	5	3	0.6
George_Carlin	wikicat_American_stand-up_comedians	8	5	3	0.6
Xi'an	wikicat_Sub-provincial_cities_in_the_People's_Republic_of_China	8	5	3	0.6
Culture_Club	wikicat_English_New_Wave_musical_groups	8	5	3	0.6
FC_Chiasso	wikicat_Football_clubs_in_Switzerland	8	5	3	0.6
Charles_Scott_Sherrington	wikicat_19th-century_physicians	3645	2281	1364	0.5979833406400702
Santiago_Salcedo	wikicat_Club_Atlético_Lanús_footballers	322	202	120	0.594059405940594
Anderlecht	wikicat_Municipalities_of_the_Brussels-Capital_Region	16458	10343	6115	0.5912211157304457
Mário_Soares	wikicat_Portuguese_Communist_Party_politicians	2440	1535	905	0.5895765472312704
FC_Chiasso	wikicat_Association_football_clubs_established_in_1905	11026	6949	4077	0.5867031227514751
PSFC_Chernomorets_Burgas	wikicat_Sports_clubs_established_in_2005	4961	3134	1827	0.5829610721123165
Gary_Teale	wikicat_Sheffield_Wednesday_F.C._players	193	122	71	0.5819672131147541
Dieter_Van_Tornhout	wikicat_Nea_Salamina_Famagusta_FC_players	60	38	22	0.5789473684210527
GLAAD_Media_Award	wikicat_Spanish_awards	666	422	244	0.5781990521327014
Aaran_Lines	wikicat_SV_Werder_Bremen_II_players	1722	1093	629	0.57548032936871
Alex_Mathie	wikicat_Greenock_Morton_F.C._players	63	40	23	0.575
Greta_Scacchi	wikicat_English_stage_actresses	74	47	27	0.574468085106383
Robert_Taylor_(footballer)	wikicat_Brentford_F.C._players	74	47	27	0.574468085106383
Cornwall	wikicat_Peninsulas	118	75	43	0.5733333333333334
Anel_Canales	wikicat_Once_Municipal_footballers	11	7	4	0.5714285714285714
Gary_Moore	wikicat_Rock_guitarists	11	7	4	0.5714285714285714
Kolkata	wikicat_Port_cities	11	7	4	0.5714285714285714
Carlos_Pavón	wikicat_2010_FIFA_World_Cup_players	11	7	4	0.5714285714285714
Omagh	wikicat_Cities_in_the_United_Kingdom	132	84	48	0.5714285714285714
Saul_Kripke	wikicat_People_from_Omaha,_Nebraska	5195	3312	1883	0.5685386473429952
Woking_F.C.	wikicat_Football_clubs_in_Surrey	15333	9784	5549	0.5671504497138184
Jefthon	wikicat_FC_Rubin_Kazan_players	456	291	165	0.5670103092783505
Rotherham_United_F.C.	wikicat_Association_football_clubs_established_in_1925	1339	855	484	0.5660818713450292
Joseph_Schumpeter	wikicat_Harvard_University_people	2161	1381	780	0.5648081100651702
Nenad_Mladenović	wikicat_Changsha_Ginde_players	4595	2937	1658	0.564521620701396
Dimba	wikicat_Goiás_Esporte_Clube_players	50	32	18	0.5625
Géza_Kalocsay	wikicat_Hungarian_expatriates_in_Poland	17019	10901	6118	0.5612329144115219
Maurice_Ross	wikicat_Viking_FK_players	490	314	176	0.5605095541401274
Pete_Seeger	wikicat_Harvard_University_alumni	39	25	14	0.56
Jorge_Costa	wikicat_Portuguese_expatriates_in_England	92	59	33	0.559322033898305
John_O'Rourke_(footballer)	wikicat_Rangers_F.C._(Johannesburg)_players	7232	4648	2584	0.5559380378657487
Faroe_Islands	wikicat_States_and_territories_established_in_1948	107	69	38	0.5507246376811594
Republican_Party_(United_States)	wikicat_Right-wing_parties	31	20	11	0.55
John_Grisham	wikicat_American_thriller_writers	17864	11539	6325	0.5481410867492851
Ronald_Colman	wikicat_British_screenwriters	17	11	6	0.5454545454545454
Archie_Thompson	wikicat_K._Lierse_S.K._players	377	244	133	0.5450819672131147
Jim_Kerr_(footballer_born_1959)	wikicat_Airdrieonians_F.C._(1878)_players	122	79	43	0.5443037974683544
Karl_Bermingham	wikicat_Monaghan_United_F.C._players	159	103	56	0.5436893203883495
Virginia_Commonwealth_University	wikicat_Educational_institutions_established_in_1968	9191	5960	3231	0.5421140939597315
Robert_Anton_Wilson	wikicat_People_from_Brooklyn	20	13	7	0.5384615384615384
Thomas_Jefferson	wikicat_American_farmers	340	221	119	0.5384615384615384
K.A.A._Gent	wikicat_Association_football_clubs_established_in_1864	16599	10798	5801	0.5372291165030562
Guilherme_de_Cássio_Alves	wikicat_Rayo_Vallecano_footballers	475	309	166	0.5372168284789643
Tom_Pondeljak	wikicat_Melbourne_Knights_FC_players	6184	4029	2155	0.5348721767187887
David_Hume	wikicat_Scottish_atheists	15010	9782	5228	0.5344510325086894
Plovdiv	wikicat_Ancient_cities	23	15	8	0.5333333333333333
Andrej_Hesek	wikicat_Slovakia_international_footballers	23	15	8	0.5333333333333333
Adalto_Batista_da_Silva	wikicat_Esporte_Clube_Santo_André_players	222	145	77	0.5310344827586206
David_Seaman	wikicat_Association_football_goalkeepers	75	49	26	0.5306122448979592
Natasha_Richardson	wikicat_People_educated_at_St_Paul's_Girls'_School	104	68	36	0.5294117647058824
Central_Connecticut_State_University	wikicat_Educational_institutions_established_in_1849	9273	6070	3203	0.5276771004942339
Dave_Mitchell_(footballer)	wikicat_NEC_Nijmegen_players	665	436	229	0.5252293577981652
Roger_Glover	wikicat_English_record_producers	250	164	86	0.524390243902439
Umm_Salal_SC	wikicat_Football_clubs_in_Qatar	10364	6834	3530	0.5165349721978344
Andrej_Hesek	wikicat_FK_Senica_players	12771	8429	4342	0.5151263495076521
Mauritius	wikicat_Islands_of_the_Indian_Ocean	139	92	47	0.5108695652173914
Simon_Grand	wikicat_Aldershot_Town_F.C._players	74	49	25	0.5102040816326531
County_Londonderry	wordnet_administrative_district_108491826	1258	833	425	0.5102040816326531
Ioan_Sabău	wikicat_Romania_international_footballers	3	2	1	0.5
Allan_Michaelsen	wikicat_Danish_football_managers	6	4	2	0.5
Costel_Orac	wikicat_Romanian_footballers	3	2	1	0.5
Nahdat_Berkane	wikicat_Football_clubs_in_Morocco	3	2	1	0.5
Aldo_Adorno	wikicat_Paraguayan_footballers	3	2	1	0.5
Foeke_Booy	wikicat_FC_Groningen_players	3	2	1	0.5
Cole_Porter	wikicat_American_musicians	3	2	1	0.5
Hermanni_Vuorinen	wikicat_Finland_international_footballers	3	2	1	0.5
David_Hilbert	wikicat_German_mathematicians	3	2	1	0.5
Andreas_Dahl	wikicat_Sweden_international_footballers	3	2	1	0.5
Bruno_Rodriguez	wikicat_Premier_League_players	3	2	1	0.5
Nicollette_Sheridan	wikicat_English_actresses	3	2	1	0.5
Bronisław_Komorowski	wikicat_Grand_Officers_of_the_Order_of_Merit_of_the_Italian_Republic	3	2	1	0.5
Yuriy_Tselykh	wikicat_FC_Metalist_Kharkiv_players	6	4	2	0.5
Yevhen_Lutsenko	wikicat_Swiss_Super_League_players	3	2	1	0.5
Michel_Debré	wikicat_20th-century_French_politicians	3	2	1	0.5
FK_Liepājas_Metalurgs	wordnet_club_108227214	3	2	1	0.5
Jonathan_Lethem	wikicat_21st-century_American_writers	3	2	1	0.5
Piotr_Rocki	wikicat_Górnik_Zabrze_players	9	6	3	0.5
Mohéli	wikicat_Island_countries	3	2	1	0.5
Prithviraj_Sukumaran	wikicat_Male_actors_in_Hindi_cinema	3	2	1	0.5
Djamel_Abdoun	wikicat_Ligue_2_players	3	2	1	0.5
Debbie_Reynolds	wikicat_21st-century_American_actresses	3	2	1	0.5
Émile_Mpenza	wikicat_Expatriate_footballers_in_Switzerland	3	2	1	0.5
Tommy_Tynan	wikicat_Swansea_City_A.F.C._players	6	4	2	0.5
Biloela	wikicat_Populated_places_in_Queensland	3	2	1	0.5
Anton_Žlogar	wikicat_Slovenia_international_footballers	3	2	1	0.5
Adam_Rooney	wikicat_Scottish_Football_League_players	9	6	3	0.5
M._S._Swaminathan	wikicat_Fellows_of_Bangladesh_Academy_of_Sciences	3	2	1	0.5
Dejan_Grabič	wikicat_NK_Domžale_players	3	2	1	0.5
Paulo_Marcel_Pereira_Merabet	wikicat_Brazilian_expatriate_footballers	3	2	1	0.5
Stephen_Fry	wikicat_English_male_film_actors	3	2	1	0.5
Friedrich_Heinrich_Jacobi	wikicat_German_philosophers	3	2	1	0.5
Christian_Alder	wikicat_German_footballers	3	2	1	0.5
Barack_Obama	wikicat_Living_people	6	4	2	0.5
Mario_Cáceres	wikicat_Chilean_Primera_División_players	9	6	3	0.5
Rosa_Luxemburg	wikicat_Polish_people	3	2	1	0.5
George_Gebro	wikicat_Ethnikos_Achna_FC_players	9	6	3	0.5
Andrey_Yeshchenko	wikicat_Russian_footballers	3	2	1	0.5
Joe_Cocker	wikicat_English_rock_singers	9	6	3	0.5
Kenya	wikicat_East_African_countries	3	2	1	0.5
Thom_Yorke	wikicat_English_male_singers	3	2	1	0.5
Ingolstadt	wikicat_University_towns_in_Germany	3	2	1	0.5
Aydın_Yılmaz	wikicat_Turkish_people	3	2	1	0.5
Bernard_Hill	wikicat_British_actors	3	2	1	0.5
Hinsdale,_Illinois	wikicat_Villages_in_Cook_County,_Illinois	3	2	1	0.5
Michael_Nelson_(footballer)	wikicat_Scunthorpe_United_F.C._players	183	122	61	0.5
Foeke_Booy	wikicat_FC_Utrecht_players	3	2	1	0.5
CD_Numancia	wikicat_Multi-sport_clubs_in_Spain	3	2	1	0.5
Empoli_F.C.	wikicat_Football_clubs_in_Tuscany	9	6	3	0.5
George_Lawrence_(footballer)	wikicat_English_footballers	3	2	1	0.5
Heiðar_Helguson	wikicat_Expatriate_footballers_in_England	6	4	2	0.5
Flevoland	wikicat_NUTS_2_statistical_regions_of_the_European_Union	3	2	1	0.5
Aydın_Yılmaz	wikicat_Turkey_youth_international_footballers	3	2	1	0.5
George_H._W._Bush	wikicat_20th-century_American_writers	12	8	4	0.5
Jared_Borgetti	wikicat_Club_León_footballers	3	2	1	0.5
R.A.A._Louviéroise	wordnet_club_108227214	3	2	1	0.5
Peter_Kropotkin	wikicat_Russian_writers	3	2	1	0.5
Stephen_Dorff	wikicat_21st-century_American_male_actors	9	6	3	0.5
Stephen_Fry	wikicat_Writers	3	2	1	0.5
Nottingham	wikicat_University_towns_in_the_United_Kingdom	24	16	8	0.5
Adriano_Ferreira_Silvestre	wikicat_Associação_Portuguesa_de_Desportos_players	51	34	17	0.5
Fernando_Pessoa	wikicat_Portuguese-language_writers	54	36	18	0.5
Lionel_Jospin	wikicat_Prime_Ministers_of_France	3	2	1	0.5
APOP_Kinyras_FC	wikicat_Football_clubs_in_Cyprus	87	58	29	0.5
Ethiopia	wikicat_Federal_countries	30	20	10	0.5
Pińczów_County	wikicat_Counties_of_Poland	3	2	1	0.5
Edward_Burns	wikicat_American_people_of_Irish_descent	15	10	5	0.5
East_Timor	wikicat_Least_developed_countries	6	4	2	0.5
Heilbronn	wikicat_Cities_in_Baden-Württemberg	3	2	1	0.5
Marc_Anthony	wikicat_American_male_film_actors	3	2	1	0.5
University_of_Hawaii_at_Manoa	wikicat_Land-grant_universities_and_colleges	3	2	1	0.5
Jim_Rodwell	wikicat_Darlington_F.C._players	166	111	55	0.4954954954954955
Kid_Rock	wikicat_Warner_Music_Group_artists	291	195	96	0.49230769230769234
Robbie_Herrera	wikicat_Leyton_Orient_F.C._players	164	110	54	0.4909090909090909
Dimba	wikicat_Leça_F.C._players	15122	10160	4962	0.48838582677165354
Thomas_Paine	wikicat_18th-century_English_writers	15302	10281	5021	0.4883766170605972
Sigmund_Freud	wikicat_Austrian_scientists	55	37	18	0.4864864864864865
Alexandre_Faioli	wikicat_Brazilian_expatriates_in_Portugal	368	248	120	0.4838709677419355
NK_Krka	wikicat_Association_football_clubs_established_in_1922	40	27	13	0.48148148148148145
Stan_Laurel	wikicat_Music_hall_performers	194	131	63	0.48091603053435117
Bonnyrigg_White_Eagles_FC	wikicat_Serbian_sports_clubs_in_Australia	14252	9627	4625	0.4804196530591046
Mounir_El_Hamdaoui	wikicat_Dutch_people_of_Moroccan_descent	16519	11160	5359	0.48019713261648744
Murfreesboro,_Tennessee	wikicat_Former_United_States_state_capitals	37	25	12	0.48
Prince_Philip,_Duke_of_Edinburgh	wikicat_British_people_of_German_descent	5234	3548	1686	0.47519729425028184
Donald_Davidson_(philosopher)	wikicat_Action_theorists	1578	1070	508	0.4747663551401869
Allan_Nielsen	wikicat_1998_FIFA_World_Cup_players	28	19	9	0.47368421052631576
Glen_Moss	wikicat_Liga_I_players	387	263	124	0.4714828897338403
Luiz_Antônio_de_Oliveira	wikicat_Santos_Futebol_Clube_players	25	17	8	0.47058823529411764
David_Watson_(footballer_born_1946)	wikicat_Fort_Lauderdale_Sun_players	15850	10793	5057	0.4685444269433892
Edson_Ratinho	wikicat_RCD_Mallorca_footballers	267	182	85	0.46703296703296704
Alexander_Haig	wikicat_American_corporate_directors	792	540	252	0.4666666666666667
Nine_Lives_(2005_film)	wikicat_2005_films	293	200	93	0.465
Alfred_Tarski	wikicat_American_philosophers	41	28	13	0.4642857142857143
Leominster,_Massachusetts	wikicat_Populated_places_established_in_1653	19	13	6	0.46153846153846156
Pierre_Méhaignerie	wikicat_French_Ministers_of_Agriculture	19	13	6	0.46153846153846156
Alex_Mathie	wikicat_Port_Vale_F.C._players	108	74	34	0.4594594594594595
Doncaster	wikicat_Railway_towns_in_England	86	59	27	0.4576271186440678
Haruki_Murakami	wikicat_20th-century_translators	17886	12274	5612	0.45722665797620987
John_Eccles_(neurophysiologist)	wikicat_Companions_of_the_Order_of_Australia	6144	4218	1926	0.4566145092460882
Kathleen_Wynne	wikicat_People_from_Ontario	821	564	257	0.45567375886524825
Elgin,_Illinois	wikicat_Cities_in_Kane_County,_Illinois	16861	11584	5277	0.4555421270718232
Robert_Montgomery_(actor)	wikicat_Presidents_of_the_Screen_Actors_Guild	1473	1012	461	0.45553359683794464
50_Cent	wikicat_American_male_singers	16	11	5	0.45454545454545453
Michele_Fini	wikicat_A.C._Siena_players	32	22	10	0.45454545454545453
Lulu_(singer)	wikicat_Mercury_Records_artists	485	334	151	0.45209580838323354
Mexico_City	wikicat_Capital_districts_and_territories	45	31	14	0.45161290322580644
Jerry_Siegel	wikicat_Jewish_American_writers	90	62	28	0.45161290322580644
Kuwait_City	wordnet_administrative_district_108491826	87	60	27	0.45
Mexico_national_under-23_football_team	wikicat_National_sports_teams_of_Mexico	58	40	18	0.45
Michele_Fini	wikicat_Cagliari_Calcio_players	200	138	62	0.4492753623188406
Wellingborough	wikicat_Post_towns_in_the_NN_postcode_area	14329	9903	4426	0.44693527213975565
Andy_King_(footballer,_born_1956)	wikicat_Cobh_Ramblers_F.C._players	15427	10680	4747	0.4444756554307116
Pepe_Reina	wikicat_UEFA_Euro_2008_players	52	36	16	0.4444444444444444
All_the_Invisible_Children	wikicat_French_documentary_films	78	54	24	0.4444444444444444
Arvid_E._Gillstrom	wikicat_American_film_directors	13	9	4	0.4444444444444444
KV_Mechelen	wikicat_Association_football_clubs_established_in_1904	62	43	19	0.4418604651162791
Rosa_Luxemburg	wikicat_Executed_revolutionaries	17328	12041	5287	0.43908313263018023
Oleksiy_Horodov	wikicat_PFC_Olexandria_players	23	16	7	0.4375
José_Luis_Garcés	wikicat_Club_Nacional_de_Football_players	46	32	14	0.4375
Manuel_Almunia	wikicat_CA_Osasuna_footballers	99	69	30	0.43478260869565216
TSG_Neustrelitz	wikicat_Football_clubs_in_Mecklenburg-Vorpommern	16722	11662	5060	0.433887840850626
Nassim_Mendil	wikicat_A.C._Ancona_players	43	30	13	0.43333333333333335
Columbia,_Missouri	wikicat_Busking_venues	14021	9792	4229	0.43188316993464054
Kenny_Stamatopoulos	wikicat_Lyn_Fotball_players	63	44	19	0.4318181818181818
Srgjan_Zaharievski	wikicat_FK_Teteks_players	15045	10515	4530	0.43081312410841655
Liam_Neeson	wikicat_American_people	10	7	3	0.42857142857142855
Jaipur	wikicat_Planned_cities_in_India	10	7	3	0.42857142857142855
Cornwall	wikicat_NUTS_2_statistical_regions_of_the_United_Kingdom	10	7	3	0.42857142857142855
Roy_Orbison	wikicat_Songwriters_from_Texas	1282	898	384	0.42761692650334077
Sayaji_Shinde	wikicat_Actors_in_Kannada_cinema	15303	10721	4582	0.427385505083481
Hong_Kong	wikicat_Port_cities	84	59	25	0.423728813559322
Liberty_University	wikicat_Universities_and_colleges_affiliated_with_the_Southern_Baptist_Convention	13167	9289	3878	0.41748304446119067
Bruno_Alves	wikicat_Portuguese_expatriates_in_Greece	170	120	50	0.4166666666666667
BC_Avtodor_Saratov	wordnet_club_108227214	17	12	5	0.4166666666666667
Garry_Thompson_(footballer_born_1959)	wikicat_Northampton_Town_F.C._players	102	72	30	0.4166666666666667
Harvey_Prize	wikicat_International_awards	17	12	5	0.4166666666666667
Trinity_College,_Cambridge	wikicat_Organisations_based_in_Cambridge_with_royal_patronage	313	221	92	0.416289592760181
Stephen_Hawking	wikicat_20th-century_astronomers	58	41	17	0.4146341463414634
Sylvia_Plath	wikicat_Pulitzer_Prize_winners	246	174	72	0.41379310344827586
Sociedade_Esportiva_Matonense	wikicat_Football_clubs_in_São_Paulo_(state)	205	145	60	0.41379310344827586
Formartine_United_F.C.	wikicat_Association_football_clubs_established_in_1946	680	481	199	0.41372141372141374
Coral_Gables,_Florida	wikicat_Populated_places_established_in_1925	9870	6992	2878	0.4116132723112128
Ben_Sahar	wikicat_RCD_Espanyol_footballers	247	175	72	0.4114285714285714
Boaz_Myhill	wikicat_Stockport_County_F.C._players	62	44	18	0.4090909090909091
Mark_Williams_(South_African_footballer)	wikicat_Al_Shabab_FC_(Riyadh)_players	15678	11130	4548	0.4086253369272237
John_Stuart_Mill	wikicat_British_feminists	59	42	17	0.40476190476190477
Rosa_Luxemburg	wikicat_Anti-poverty_advocates	9309	6644	2665	0.4011137868753763
John_Badham	wikicat_American_television_directors	7	5	2	0.4
English_language	wikicat_Languages_of_the_United_States	14	10	4	0.4
Haiti	wikicat_Member_states_of_the_Caribbean_Community	7	5	2	0.4
Cole_Porter	wikicat_Musical_theatre_composers	7	5	2	0.4
Kung_Fu_Panda	wikicat_Paramount_Pictures_films	7	5	2	0.4
Robin_Cook_(American_novelist)	wikicat_20th-century_physicians	3648	2614	1034	0.3955623565416985
War_of_the_Second_Coalition	wikicat_Wars_involving_the_Ottoman_Empire	53	38	15	0.39473684210526316
Ryan_Jarvis	wikicat_Torquay_United_F.C._players	131	94	37	0.39361702127659576
Marques_Houston	wikicat_American_people_of_Mexican_descent	4140	2973	1167	0.39253279515640765
Dorin_Goian	wikicat_FCM_Bacău_players	16966	12188	4778	0.3920249425664588
Barcelona	wikicat_University_towns	32	23	9	0.391304347826087
Modeste_M'bami	wikicat_Olympic_medalists_in_football	75	54	21	0.3888888888888889
Frédéric_Nimani	wikicat_AC_Arles-Avignon_players	100	72	28	0.3888888888888889
Daniel_Nannskog	wikicat_Expatriate_footballers_in_China	262	189	73	0.3862433862433862
James_Robertson_Justice	wikicat_British_journalists	456	329	127	0.3860182370820669
Lionel_Jospin	wikicat_Lycée_Janson_de_Sailly_alumni	18	13	5	0.38461538461538464
Susan_Sontag	wikicat_American_historical_novelists	17385	12565	4820	0.3836052526860326
Melbourne_Airport	wikicat_Airports_established_in_1970	13419	9713	3706	0.38155049933079377
Migen_Memelli	wikicat_GAIS_Göteborg_players	8258	5978	2280	0.38139846102375374
Jean_Fuller	wikicat_People_from_Bakersfield,_California	29	21	8	0.38095238095238093
University_of_Cambridge	wikicat_Educational_institutions_established_in_the_13th_century	14293	10379	3914	0.3771076211581077
Sékou_Berthé	wikicat_Persepolis_F.C._players	903	656	247	0.37652439024390244
University_of_South_Africa	wikicat_Distance_education_institutions	13354	9710	3644	0.3752832131822863
Stephan_Kling	wikicat_Association_football_defenders	11	8	3	0.375
Mia_Farrow	wikicat_Transcendental_Meditation_practitioners	1694	1232	462	0.375
Estonia	wikicat_Baltic_states	11	8	3	0.375
Ioan_Sabău	wikicat_1990_FIFA_World_Cup_players	44	32	12	0.375
Óscar_Díaz_González	wikicat_CD_Lugo_footballers	14981	10924	4057	0.37138410838520686
Chick_Corea	wikicat_GRP_Records_artists	14716	10737	3979	0.3705876874359691
Aldo_Adorno	wikicat_Naturalised_citizens_of_Spain	1145	839	306	0.36471990464839094
Alexandre_Millerand	wikicat_French_socialists	15	11	4	0.36363636363636365
Kylie_Minogue	wikicat_Capitol_Records_artists	165	121	44	0.36363636363636365
Williams_Martínez	wikicat_Ferro_Carril_Oeste_footballers	94	69	25	0.36231884057971014
Viggo_Mortensen	wikicat_American_painters	672	494	178	0.3603238866396761
Rangers_F.C.	wikicat_Association_football_clubs_established_in_1872	34	25	9	0.36
Tony_Bennett	wikicat_American_jazz_musicians	1433	1055	378	0.3582938388625592
Mark_Owen	wikicat_Chadderton_F.C._players	8580	6317	2263	0.3582396707297768
Jonathan_Walters	wikicat_Crewe_Alexandra_F.C._players	19	14	5	0.35714285714285715
Flinders_University	wikicat_Educational_institutions_established_in_1966	14588	10759	3829	0.35588809368900454
Cluj-Napoca	wikicat_Capitals_of_the_Principality_of_Transylvania	12726	9411	3315	0.3522473700988205
C._S._Lewis	wikicat_Science_fiction_writers	96	71	25	0.352112676056338
Patricio_Pérez	wikicat_Club_León_footballers	150	111	39	0.35135135135135137
Spellemannprisen	wikicat_Awards_established_in_1973	16239	12017	4222	0.3513356078888242
Kigali	wikicat_Populated_places_established_in_1907	4532	3356	1176	0.3504171632896305
Stevenage	wikicat_New_towns_in_England	27	20	7	0.35
Julianne_Moore	wikicat_21st-century_American_writers	62	46	16	0.34782608695652173
Diana_Dors	wikicat_Converts_to_Roman_Catholicism	171	127	44	0.3464566929133858
Club_Atlético_de_Madrid	wikicat_Association_football_clubs_established_in_1903	1232	915	317	0.346448087431694
Trabzon	wikicat_Capitals_of_former_nations	35	26	9	0.34615384615384615
Chamois_Niortais_F.C.	wikicat_Association_football_clubs_established_in_1925	39	29	10	0.3448275862068966
Marie_Curie	wikicat_Women_Nobel_laureates	7259	5399	1860	0.3445082422670865
Stefan_Majewski	wikicat_Polonia_Warsaw_managers	43	32	11	0.34375
MFK_Ružomberok	wordnet_club_108227214	98	73	25	0.3424657534246575
Olivia_Newton-John	wikicat_British_television_actresses	3120	2325	795	0.3419354838709677
Roberto_Merino	wikicat_Akratitos_FC_players	232	173	59	0.34104046242774566
Phil_Charnock	wikicat_Port_Vale_F.C._players	71	53	18	0.33962264150943394
Charles_K._Kao	wikicat_Alumni_of_the_University_of_Greenwich	15322	11438	3884	0.33956985486973246
Evando	wikicat_Avaí_Futebol_Clube_players	95	71	24	0.3380281690140845
Rosa_Luxemburg	wikicat_Feminists	539	403	136	0.337468982630273
Javier_Marías	wikicat_Translators_to_Spanish	16699	12491	4208	0.33688255543991674
Sylvia_Plath	wikicat_Writers_from_Boston,_Massachusetts	4526	3393	1133	0.33392278219864424
Alex_Nyarko	wikicat_Expatriate_footballers_in_Switzerland	4	3	1	0.3333333333333333
Mamadou_Bagayoko	wikicat_Ligue_2_players	4	3	1	0.3333333333333333
Elgin,_Illinois	wordnet_administrative_district_108491826	4	3	1	0.3333333333333333
Miguel_Ferrer	wikicat_American_film_directors	4	3	1	0.3333333333333333
George_Clinton_(musician)	wikicat_21st-century_American_singers	4	3	1	0.3333333333333333
Intel	wikicat_Computer_companies_of_the_United_States	4	3	1	0.3333333333333333
Cameroon	wikicat_Member_states_of_the_Commonwealth_of_Nations	4	3	1	0.3333333333333333
Manuel_Almunia	wikicat_Spanish_expatriate_footballers	4	3	1	0.3333333333333333
Antonella_Gambotto-Burke	wordnet_writer_110794014	4	3	1	0.3333333333333333
Jair_Baylón	wikicat_Torneo_Descentralizado_footballers	4	3	1	0.3333333333333333
Munich	wikicat_German_state_capitals	4	3	1	0.3333333333333333
Andy_Williams_(Jamaican_footballer)	wikicat_Chicago_Fire_Soccer_Club_players	4	3	1	0.3333333333333333
Marcos_Alonso_Peña	wikicat_Sevilla_FC_managers	4	3	1	0.3333333333333333
Ricardo_Sousa	wikicat_Segunda_Divisão_players	4	3	1	0.3333333333333333
Yevhen_Lutsenko	wikicat_FC_Zorya_Luhansk_players	4	3	1	0.3333333333333333
Immanuel_Kant	wikicat_Political_philosophers	4	3	1	0.3333333333333333
Tony_Bennett	wikicat_20th-century_American_singers	8	6	2	0.3333333333333333
Niklas_Andersen	wikicat_German_footballers	4	3	1	0.3333333333333333
Wolverhampton	wikicat_NUTS_3_statistical_regions_of_the_United_Kingdom	4	3	1	0.3333333333333333
Éric_Besson	wikicat_Politicians_of_the_French_Fifth_Republic	4	3	1	0.3333333333333333
Hristo_Stoichkov	wikicat_PFC_CSKA_Sofia_players	4	3	1	0.3333333333333333
Liv_Tyler	wikicat_20th-century_actresses	4	3	1	0.3333333333333333
Irvine,_North_Ayrshire	wikicat_Ports_and_harbours_of_Scotland	4	3	1	0.3333333333333333
Autodromo_Nazionale_Monza	wordnet_venue_108677628	4	3	1	0.3333333333333333
Martin_Heidegger	wikicat_Continental_philosophers	4	3	1	0.3333333333333333
Carl_Friedrich_Gauss	wikicat_Optical_physicists	4	3	1	0.3333333333333333
Daniel_Arismendi	wikicat_Venezuelan_expatriate_footballers	4	3	1	0.3333333333333333
Barry_Manilow	wikicat_American_singers	4	3	1	0.3333333333333333
Mississippi_River	wikicat_Borders_of_Tennessee	4	3	1	0.3333333333333333
Maroš_Klimpl	wikicat_Expatriate_footballers_in_the_Czech_Republic	4	3	1	0.3333333333333333
Aitor_Ocio	wikicat_Spanish_people	4	3	1	0.3333333333333333
Ihor_Zhabchenko	wikicat_FC_Zirka_Kirovohrad_managers	4	3	1	0.3333333333333333
Julio_Salinas	wikicat_Basque_footballers	4	3	1	0.3333333333333333
Richard_Francis-Bruce	wikicat_Australian_people	4	3	1	0.3333333333333333
Luigi_De_Canio	wikicat_A.S._Livorno_Calcio_players	4	3	1	0.3333333333333333
Aidan_Davison	wikicat_Hull_City_A.F.C._players	4	3	1	0.3333333333333333
Matisyahu	wikicat_American_male_singers	4	3	1	0.3333333333333333
Toruń_County	wikicat_Land_counties_of_Kuyavian-Pomeranian_Voivodeship	4	3	1	0.3333333333333333
Alexander_Søderlund	wikicat_Norwegian_footballers	4	3	1	0.3333333333333333
Tupac_Shakur	wikicat_Rappers_from_New_York_City	8	6	2	0.3333333333333333
Luigi_De_Canio	wikicat_Italian_football_managers	4	3	1	0.3333333333333333
Friedrichshafen	wikicat_Populated_places_on_Lake_Constance	24	18	6	0.3333333333333333
Ludwig_Boltzmann	wikicat_Austrian_physicists	12	9	3	0.3333333333333333
Lee_Johnson_(footballer)	wikicat_Football_Conference_players	24	18	6	0.3333333333333333
Buckethead	wikicat_Lead_guitarists	16	12	4	0.3333333333333333
Manchester_Monarchs	wikicat_Sports_clubs_established_in_2001	28	21	7	0.3333333333333333
Order_of_the_Holy_Spirit	wikicat_Civil_awards_and_decorations_of_France	12	9	3	0.3333333333333333
Anne,_Princess_Royal	wikicat_Royal_Olympic_participants	15753	11822	3931	0.3325156487903908
Chien-Shiung_Wu	wikicat_20th-century_women	309	232	77	0.33189655172413796
Hadley,_Massachusetts	wikicat_Populated_places_in_Hampshire_County,_Massachusetts	12298	9248	3050	0.3298010380622837
Hilary_Duff	wikicat_Animal_rights_advocates	89	67	22	0.3283582089552239
Roy_Ashburn	wordnet_state_senator_110650076	77	58	19	0.3275862068965517
Olubayo_Adefemi	wikicat_Skoda_Xanthi_F.C._players	454	342	112	0.32748538011695905
Martin_Woods	wikicat_Yeovil_Town_F.C._players	219	165	54	0.32727272727272727
Jørgen_Kristensen	wikicat_Sparta_Rotterdam_players	110	83	27	0.3253012048192771
Jennifer_Lopez	wikicat_American_television_producers	90	68	22	0.3235294117647059
Preston,_Lancashire	wikicat_Post_towns_in_the_PR_postcode_area	15886	12005	3881	0.3232819658475635
Sofia_Coppola	wikicat_American_women_film_directors	348	263	85	0.3231939163498099
Bas_Savage	wikicat_Walton_&amp;_Hersham_F.C._players	37	28	9	0.32142857142857145
Frank_Fahrenhorst	wikicat_People_from_North_Rhine-Westphalia	746	566	180	0.31802120141342755
Bert_Gosnell	wikicat_Gillingham_F.C._players	46	35	11	0.3142857142857143
Bakhtiyor_Ashurmatov	wikicat_FC_Bunyodkor_players	3865	2942	923	0.31373215499660095
Namur	wordnet_administrative_district_108491826	21	16	5	0.3125
Steve_Croudson	wikicat_Players_in_the_Welsh_Premier_League	139	106	33	0.3113207547169811
Pierre_Teilhard_de_Chardin	wikicat_Villanova_University_alumni	9349	7134	2215	0.3104850014017382
Gustavo_Napoles	wikicat_Chiapas_F.C._footballers	38	29	9	0.3103448275862069
Watford_F.C.	wikicat_Association_football_clubs_established_in_1881	72	55	17	0.3090909090909091
Olubayo_Adefemi	wikicat_Hapoel_Bnei_Lod_F.C._players	16278	12443	3835	0.3082054167001527
Aaron_Brown_(footballer_born_1980)	wikicat_Lincoln_City_F.C._players	85	65	20	0.3076923076923077
Jeff_Betts	wikicat_Portland_Pilots_men's_soccer_players	15647	12006	3641	0.3032650341495919
Seol_Ki-hyeon	wikicat_Reading_F.C._players	117	90	27	0.3
Sunil_Shetty	wikicat_Actors	13	10	3	0.3
Fidesz	wikicat_Christian_democratic_parties	13	10	3	0.3
Steven_Tyler	wikicat_American_people_of_German_descent	13	10	3	0.3
Talia_Shire	wikicat_Actors_from_New_York	13	10	3	0.3
David_Bohm	wikicat_Alumni_of_the_University_of_Bristol	317	244	73	0.29918032786885246
Leelanau_County,_Michigan	wikicat_Populated_places_established_in_1840	17968	13837	4131	0.29854737298547374
Cole_Porter	wikicat_LGBT_composers	17364	13372	3992	0.2985342506730482
Jon_Harley	wikicat_Notts_County_F.C._players	48	37	11	0.2972972972972973
Daniel_Pendín	wikicat_CD_Castellón_footballers	35	27	8	0.2962962962962963
Bradford_Park_Avenue_A.F.C.	wikicat_Southern_Football_League_clubs	123	95	28	0.29473684210526313
Walt_Disney	wikicat_Actors_from_California	44	34	10	0.29411764705882354
Manuel_dos_Santos_Fernandes	wikicat_People_from_Praia	17350	13410	3940	0.29381058911260255
Stephen_Fry	wikicat_Jewish_humanists	3661	2834	827	0.2918136908962597
Tommy_Wright_(footballer,_born_1984)	wikicat_Corby_Town_F.C._players	16071	12453	3618	0.29053240183088413
Martin_Lejsal	wikicat_SC_Heerenveen_players	1080	837	243	0.2903225806451613
M._S._Swaminathan	wikicat_World_Food_Prize_laureates	16299	12661	3638	0.28733907274306925
Giovanny_Espinoza	wikicat_Ecuador_international_footballers	9	7	2	0.2857142857142857
Rosa_Luxemburg	wikicat_German_revolutionaries	18	14	4	0.2857142857142857
Vladislav_Stoyanov	wikicat_Neftochimic_Burgas_players	9	7	2	0.2857142857142857
Cincinnati_Mighty_Ducks	wikicat_Defunct_ice_hockey_teams	9	7	2	0.2857142857142857
Yuen_Biao	wikicat_Chinese_actors	9	7	2	0.2857142857142857
Ray_Houghton	wikicat_Scottish_people_of_Irish_descent	189	147	42	0.2857142857142857
Jade_North	wikicat_Olympic_soccer_players_of_Australia	9	7	2	0.2857142857142857
Hans-Georg_Gadamer	wikicat_Commentators_on_Aristotle	15722	12242	3480	0.2842672765887927
Georgios_Vakouftsis	wikicat_ACF_Fiorentina_players	258	201	57	0.2835820895522388
John_Stuart_Mill	wikicat_Feminist_economists	13855	10800	3055	0.2828703703703704
Dave_Mitchell_(footballer)	wikicat_Scottish_footballers	354	276	78	0.2826086956521739
S.S._Lazio	wikicat_Publicly_traded_sports_companies	59	46	13	0.2826086956521739
Bradford_Park_Avenue_A.F.C.	wikicat_Former_Football_League_clubs	50	39	11	0.28205128205128205
Iván_Obolo	wikicat_Argentine_people_of_Italian_descent	215	168	47	0.27976190476190477
Carl_Pentney	wikicat_Woking_F.C._players	110	86	24	0.27906976744186046
Rainer_Maria_Rilke	wikicat_Sonneteers	506	396	110	0.2777777777777778
S.S._Lazio	wikicat_Multi-sport_clubs_in_Italy	23	18	5	0.2777777777777778
Voltaire	wikicat_Encyclopedists	7248	5674	1574	0.2774057102573141
Janet_Frame	wikicat_New_Zealand_people_of_Scottish_descent	1793	1405	388	0.27615658362989326
Andrew_Taylor_(footballer,_born_1986)	wikicat_People_from_Hartlepool	16021	12555	3466	0.2760653126244524
Kochi	wikicat_Cities_and_towns_in_Ernakulam_district	16405	12881	3524	0.2735812436922599
Seol_Ki-hyeon	wikicat_Fulham_F.C._players	229	180	49	0.2722222222222222
Sékou_Tidiane_Souaré	wikicat_Expatriate_footballers_in_Guinea	14998	11798	3200	0.27123241227326667
Rimas_Kurtinaitis	wikicat_Basketball_players_at_the_1988_Summer_Olympics	738	581	157	0.270223752151463
Portland,_Oregon	wikicat_Cities_in_Clackamas_County,_Oregon	15757	12421	3336	0.2685774092263103
Andreas_Glyniadakis	wikicat_AEK_Athens_B.C._players	15927	12580	3347	0.2660572337042925
Aritz_Aduriz	wikicat_Spain_international_footballers	82	65	17	0.26153846153846155
Aidan_Davison	wikicat_Chester_City_F.C._players	189	150	39	0.26
fr/Avenir_sportif_de_La_Marsa_(football)	wikicat_Football_clubs_in_Tunisia	15527	12343	3184	0.25795997731507736
Charles_K._Kao	wikicat_British_emigrants_to_the_United_States	1469	1169	300	0.2566295979469632
Alex_Mathie	wikicat_West_Auckland_Town_F.C._players	16911	13459	3452	0.25648265101419127
Alexander_Herzen	wikicat_Opinion_journalists	686	546	140	0.2564102564102564
Felix_Ogbuke	wikicat_People_from_Enugu	114	91	23	0.25274725274725274
Bob_Hope	wikicat_American_boxers	15475	12356	3119	0.25242797021689867
Worthing_F.C.	wikicat_Football_clubs_in_West_Sussex	483	386	97	0.25129533678756477
Christopher_Reeve	wikicat_American_screenwriters	5	4	1	0.25
Stephan_Kling	wikicat_Germany_B_international_footballers	5	4	1	0.25
Nery_Castillo	wikicat_Chicago_Fire_Soccer_Club_players	5	4	1	0.25
Louis_Pasteur	wikicat_French_scientists	5	4	1	0.25
Kuwait	wikicat_Member_states_of_the_Cooperation_Council_for_the_Arab_States_of_the_Gulf	5	4	1	0.25
Staples_Center	wikicat_Boxing_venues	5	4	1	0.25
Ramesh_Aravind	wordnet_person_100007846	5	4	1	0.25
Oleg_Veretennikov	wikicat_FC_Rotor_Volgograd_players	15	12	3	0.25
Carl_Sagan	wikicat_20th-century_American_writers	5	4	1	0.25
Don_Hutchison	wikicat_Scotland_B_international_footballers	10	8	2	0.25
Little_Rock,_Arkansas	wikicat_Cities_in_Arkansas	5	4	1	0.25
Hugo_Carreira	wikicat_Portugal_youth_international_footballers	5	4	1	0.25
Richard_Feynman	wikicat_Manhattan_Project_people	5	4	1	0.25
Bruce_Dickinson	wikicat_English_rock_singers	5	4	1	0.25
Daniel_Prodan	wikicat_Atlético_Madrid_footballers	220	176	44	0.25
Jonesboro,_Arkansas	wikicat_Cities_in_Arkansas	5	4	1	0.25
Matías_Masiero	wikicat_A.C._Pisa_1909_players	177	142	35	0.24647887323943662
Alex_Nyarko	wikicat_Dawu_Youngstars_players	15825	12702	3123	0.24586679263108172
San_Lorenzo_de_Almagro	wikicat_Argentine_rugby_union_teams	14805	11885	2920	0.2456878418174169
Liam_Neeson	wikicat_People_from_Ballymena	16055	12929	3126	0.24178204037435222
Cardiff	wikicat_British_capitals	31	25	6	0.24
Lagos	wikicat_Port_cities	31	25	6	0.24
Aidan_Quinn	wikicat_Stage_actors	62	50	12	0.24
Dominic_Foley	wikicat_Wolverhampton_Wanderers_F.C._players	57	46	11	0.2391304347826087
John_Kerry	wikicat_Foreign_Service_brats	17342	14027	3315	0.23632993512511585
Marijo_Marić	wikicat_SV_Waldhof_Mannheim_players	152	123	29	0.23577235772357724
Liivo_Leetma	wikicat_Estonian_expatriate_footballers	16072	13018	3054	0.23459824857889078
Pierre_Trudeau	wikicat_Canadian_academics	16877	13692	3185	0.23261758691206544
Merthyr_Tydfil	wikicat_Post_towns_in_the_CF_postcode_area	16	13	3	0.23076923076923078
Julio_César_Uribe	wikicat_Peruvian_expatriates_in_Mexico	16501	13412	3089	0.23031613480465254
Alex_Mathie	wikicat_Northern_Premier_League_managers	16206	13177	3029	0.22987022842832208
Matteo_Contini	wikicat_S.S._Juve_Stabia_players	13130	10686	2444	0.22871046228710462
Cornwall	wikicat_Former_countries_in_the_British_Isles	269	219	50	0.228310502283105
James_Wesolowski	wikicat_Peterborough_United_F.C._players	696	567	129	0.2275132275132275
Jules_Vandooren	wikicat_Senegal_national_football_team_managers	16371	13343	3028	0.22693547178295737
Terrel_Castle	wikicat_AEK_Athens_B.C._players	15824	12898	2926	0.22685687703519924
Gilbert_Bodart	wikicat_K.V._Oostende_managers	17051	13904	3147	0.22633774453394706
Adolf_Hitler	wikicat_Naturalized_citizens_of_Germany	16458	13432	3026	0.2252829064919595
Christopher_Reeve	wikicat_American_male_soap_opera_actors	551	450	101	0.22444444444444445
Micky_Adams	wikicat_Leicester_City_F.C._managers	668	546	122	0.22344322344322345
Agustín_Castillo	wikicat_Expatriate_footballers_in_Costa_Rica	11	9	2	0.2222222222222222
Arabic_language	wikicat_Languages_of_the_United_Arab_Emirates	121	99	22	0.2222222222222222
Springfield,_Massachusetts	wikicat_Populated_places_on_the_Connecticut_River	143	117	26	0.2222222222222222
East_Carolina_University	wikicat_Universities_and_colleges_in_North_Carolina	11	9	2	0.2222222222222222
Panhellenic_Socialist_Movement	wikicat_Political_parties_in_Greece	13663	11184	2479	0.22165593705293277
50_Cent	wikicat_G-Unit_Records_artists	14506	11884	2622	0.22063278357455401
Chad_Harpur	wikicat_People_from_Johannesburg	15278	12527	2751	0.21960565179212901
John_Gidman	wikicat_Aston_Villa_F.C._players	440	361	79	0.2188365650969529
Hilary_Duff	wikicat_Walt_Disney_Records_artists	16542	13587	2955	0.21748730404062708
Praemium_Imperiale	wikicat_International_music_awards	28	23	5	0.21739130434782608
Jules_Vandooren	wikicat_Red_Star_Saint-Ouen_players	16107	13248	2859	0.21580615942028986
P._Bharathiraja	wikicat_Tamil_screenwriters	15567	12805	2762	0.215696993361968
Arthur_Moses	wikicat_Asante_Kotoko_F.C._players	62	51	11	0.21568627450980393
Pervez_Musharraf	wikicat_People_from_Karachi	16685	13730	2955	0.21522214129643116
Dan_Aykroyd	wikicat_Canadian_television_comedians	17	14	3	0.21428571428571427
Estudiantes_de_La_Plata	wordnet_club_108227214	17	14	3	0.21428571428571427
Lincoln,_Nebraska	wikicat_Populated_places_established_in_1856	369	304	65	0.2138157894736842
Beirut	wikicat_Phoenician_sites_in_Lebanon	15319	12648	2671	0.21117963314358001
Émile_Durkheim	wikicat_Sociologists_of_religion	14887	12300	2587	0.21032520325203252
Hans-Georg_Gadamer	wikicat_Philosophers_of_education	156	129	27	0.20930232558139536
Rennes	wikicat_Communes_of_Ille-et-Vilaine	16842	13929	2913	0.20913202670687056
Rhode_Island	wikicat_States_and_territories_established_in_1663	8595	7110	1485	0.2088607594936709
Shreveport,_Louisiana	wikicat_Cities_in_Bossier_Parish,_Louisiana	17461	14448	3013	0.2085409745293466
William_Golding	wikicat_People_from_Marlborough	14297	11831	2466	0.2084354661482546
Marco_Delvecchio	wikicat_F.B.C._Unione_Venezia_players	99	82	17	0.2073170731707317
Mike_Myers	wikicat_English_screenwriters	248	206	42	0.20388349514563106
Dieter_Van_Tornhout	wikicat_Belgian_expatriates_in_the_Netherlands	13689	11376	2313	0.20332278481012658
Liza_Minnelli	wikicat_American_people_of_French-Canadian_descent	421	350	71	0.20285714285714285
Sport_Boys	wikicat_Football_clubs_in_Peru	95	79	16	0.20253164556962025
Ronald_Coase	wikicat_Business_theorists	15053	12520	2533	0.20231629392971245
Francis_Ford_(actor)	wikicat_Male_actors_from_Maine	15426	12832	2594	0.2021508728179551
Milovan_Milović	wikicat_KS_Dinamo_Tirana_players	137	114	23	0.20175438596491227
Lucero_(entertainer)	wikicat_Mexican_actresses	13417	11176	2241	0.20051896921975662
Jacques_Derrida	wikicat_20th-century_French_writers	6	5	1	0.2
Spirits_of_the_Dead	wikicat_French-language_films	6	5	1	0.2
Ioan_Sabău	wikicat_CFM_U_Cluj_players	6	5	1	0.2
Rome	wordnet_site_108651247	6	5	1	0.2
Germán_Herrera	wikicat_San_Lorenzo_footballers	6	5	1	0.2
Leonid_Hurwicz	wikicat_Jewish_scientists	6	5	1	0.2
Błażej_Augustyn	wikicat_Expatriate_footballers_in_England	90	75	15	0.2
Brendan_Fraser	wikicat_American_voice_actors	6	5	1	0.2
Peter_Fonda	wikicat_American_film_producers	6	5	1	0.2
Preston_North_End_F.C.	wikicat_Football_League_clubs	6	5	1	0.2
Ton_Pentre_F.C.	wordnet_club_108227214	12	10	2	0.2
Terence_Tao	wikicat_Fellows_of_the_Australian_Academy_of_Science	109	91	18	0.1978021978021978
Barack_Obama	wikicat_Occidental_College_alumni	17667	14752	2915	0.19760032537960953
Bristol	wikicat_Post_towns_in_the_BS_postcode_area	12750	10652	2098	0.19695831768681937
Queen's_University	wikicat_Educational_institutions_established_in_1841	11120	9297	1823	0.19608475852425514
Billy_Boyd_(footballer)	wikicat_Southampton_F.C._players	110	92	18	0.1956521739130435
David_Byrne	wikicat_Sire_Records_artists	15144	12667	2477	0.19554748559248442
Stephen_King	wikicat_American_thriller_writers	17982	15048	2934	0.19497607655502391
Toshiko_Akiyoshi	wikicat_Music_arrangers	16436	13763	2673	0.19421637724333357
Milford,_Delaware	wikicat_Cities_in_Delaware	12557	10519	2038	0.19374465253351078
David_Bohm	wikicat_Jewish_American_scientists	37	31	6	0.1935483870967742
Comoros	wikicat_Islands_of_the_Indian_Ocean	136	114	22	0.19298245614035087
Jerzy_Skolimowski	wikicat_Polish_film_directors	16880	14168	2712	0.19141727837380013
Charlotte_Eagles	wikicat_North_Carolina_soccer_teams	13719	11517	2202	0.1911956238603803
W._S._Van_Dyke	wikicat_Vaudeville_performers	100	84	16	0.19047619047619047
Joe_Bradshaw_(footballer)	wikicat_Chelsea_F.C._players	38	32	6	0.1875
Elmore_Leonard	wikicat_Writers_from_New_Orleans,_Louisiana	14234	11988	2246	0.18735402068735402
Ronald_Arana	wikicat_Guabirá_players	14594	12297	2297	0.18679352687647394
Queen's_University	wikicat_Nursing_schools_in_Canada	10008	8433	1575	0.18676627534685167
Illés_Zsolt_Sitku	wikicat_Hungarian_expatriates_in_Turkey	14105	11893	2212	0.18599175985874045
Jacques_Chirac	wikicat_French_interior_ministers	32	27	5	0.18518518518518517
Jane_Murfin	wikicat_American_women_film_directors	493	416	77	0.18509615384615385
Kim_Nam-il	wikicat_Suwon_Samsung_Bluewings_players	45	38	7	0.18421052631578946
University_of_Chile	wikicat_Universities_in_Santiago_Metropolitan_Region	14002	11825	2177	0.1841014799154334
INXS	wikicat_Musical_groups_from_Sydney	14883	12571	2312	0.1839153607509347
Julius_Akosah	wikicat_Happy_Valley_AA_footballers	14663	12387	2276	0.1837410188100428
Jack_Cork	wikicat_People_educated_at_Glyn_School	16344	13823	2521	0.18237719742458222
Gyula_Lóránt	wikicat_20th-century_Hungarian_people	14193	12015	2178	0.18127340823970037
Roger_Glover	wikicat_Heavy_metal_bass_guitarists	16370	13867	2503	0.18050046873873224
Nemanja_Pejčinović	wikicat_Serbian_expatriates_in_France	59	50	9	0.18
Mel_Tormé	wikicat_Atlantic_Records_artists	33	28	5	0.17857142857142858
La_Paz	wikicat_Populated_places_established_in_1548	10744	9130	1614	0.17677984665936472
Vyacheslav_Sviderskyi	wikicat_FC_Alania_Vladikavkaz_players	20	17	3	0.17647058823529413
Tony_Bennett	wikicat_21st-century_American_painters	1130	961	169	0.17585848074921956
Abraham	wikicat_Prophets	15480	13168	2312	0.1755771567436209
José_Jesús_Perera	wikicat_CD_Badajoz_players	215	183	32	0.17486338797814208
The_Notorious_B.I.G.	wikicat_American_poets	88	75	13	0.17333333333333334
André_Santos	wikicat_Brazilian_expatriates_in_the_United_Kingdom	15357	13089	2268	0.17327526931010773
Alain_Delon	wikicat_21st-century_Swiss_people	14198	12120	2078	0.17145214521452146
Admir_Bilibani	wikicat_FC_Lausanne-Sport_players	41	35	6	0.17142857142857143
Rotterdam	wikicat_Port_cities_and_towns_in_the_Netherlands	15492	13229	2263	0.1710635724544561
Nicolas_Anelka	wikicat_French_expatriates_in_the_United_Kingdom	16981	14502	2479	0.17094193904289062
Mahesh_Babu	wikicat_Loyola_College,_Chennai_alumni	48	41	7	0.17073170731707318
Robert_Anton_Wilson	wikicat_American_occult_writers	15439	13193	2246	0.1702417948912302
Agustín_Castillo	wikicat_Expatriate_football_managers_in_El_Salvador	16635	14216	2419	0.17016038266741698
Janet_Frame	wikicat_20th-century_New_Zealand_novelists	14744	12619	2125	0.16839686187495048
Alexandria_(Virginia)	wikicat_Populated_places_established_in_1695	12306	10539	1767	0.16766296612581838
Graham_Stack_(footballer)	wikicat_English_people_of_Irish_descent	230	197	33	0.16751269035532995
Teri_Hatcher	wikicat_20th-century_actors	7	6	1	0.16666666666666666
Greta_Scacchi	wikicat_Australian_film_actresses	7	6	1	0.16666666666666666
Stan_Laurel	wikicat_English_male_comedians	35	30	5	0.16666666666666666
Ernst_Mach	wikicat_Philosophers_of_science	14	12	2	0.16666666666666666
Greg_Bear	wikicat_Worldcon_Guests_of_Honor	7	6	1	0.16666666666666666
All_Boys	wikicat_Basketball_teams_in_Buenos_Aires	7	6	1	0.16666666666666666
Histoire(s)_du_cinéma	wikicat_French_films	7	6	1	0.16666666666666666
Allan_Michaelsen	wikicat_Bundesliga_players	7	6	1	0.16666666666666666
Tbilisi	wikicat_Regions_of_Georgia_(country)	16071	13777	2294	0.16650939972417797
William_Maxwell_(footballer)	wikicat_Belgium_national_football_team_managers	15057	12909	2148	0.16639553799674645
Panevėžys_County	wikicat_Subdivisions_of_Lithuania	13352	11467	1885	0.16438475625708554
Daniel_Guerrero_Gómez	wikicat_UDA_Gramenet_footballers	15606	13446	2160	0.1606425702811245
Joakim_Persson	wikicat_Atalanta_B.C._players	581	501	80	0.1596806387225549
University_of_Pennsylvania	wikicat_Universities_and_colleges_in_Philadelphia,_Pennsylvania	15135	13070	2065	0.1579954093343535
John_McCain	wikicat_Jeopardy!_contestants	15447	13348	2099	0.15725202277494757
David_Sedaris	wikicat_LGBT_people	111	96	15	0.15625
Miloš_Kolaković	wikicat_Nea_Salamis_FC_players	37	32	5	0.15625
Poul_Anderson	wikicat_American_people_of_Danish_descent	1118	968	150	0.15495867768595042
Josh_Schwartz	wikicat_Television_producers	15	13	2	0.15384615384615385
Alekos_Alekou	wikicat_Aris_Limassol_players	15	13	2	0.15384615384615385
Tigres_UANL	wordnet_club_108227214	15	13	2	0.15384615384615385
Mel_Tormé	wikicat_American_male_novelists	240	208	32	0.15384615384615385
Tim_Berners-Lee	wikicat_British_physicists	15	13	2	0.15384615384615385
Paulo_Marcel_Pereira_Merabet	wikicat_Clube_do_Remo_players	429	372	57	0.1532258064516129
Christian_Bassila	wikicat_French_expatriates_in_Greece	16213	14081	2132	0.15140970101555287
Eleftheria_Arvanitaki	wikicat_Modern_Greek-language_singers	15648	13600	2048	0.15058823529411763
S.S._Felice_Scandone	wikicat_Sports_clubs_established_in_1948	15322	13325	1997	0.1498686679174484
Jade_North	wikicat_Association_football_central_defenders	123	107	16	0.14953271028037382
Cabeça_do_Cachorro	wikicat_Regions_of_South_America	11648	10135	1513	0.1492846571287617
Joseph-Désiré_Job	wikicat_Middlesbrough_F.C._players	262	228	34	0.14912280701754385
Fausto_Lourenço	wikicat_PFC_Lokomotiv_Mezdra_players	13611	11857	1754	0.1479294931264232
Nicolas_Sahnoun	wikicat_UD_Almería_footballers	257	224	33	0.14732142857142858
Toshiko_Akiyoshi	wikicat_American_musicians_of_Japanese_descent	16646	14513	2133	0.14697168056225454
Russian_Civil_War	wikicat_Conflicts_in_1919	12626	11022	1604	0.14552712756305572
Red_Sea	wordnet_lake_109328904	14381	12557	1824	0.14525762522895597
Marie_Curie	wikicat_Women_chemists	13960	12194	1766	0.14482532392980155
Greg_Strong	wikicat_Bury_F.C._players	120	105	15	0.14285714285714285
Poland	wikicat_States_and_territories_established_in_1918	8	7	1	0.14285714285714285
Hameur_Bouazza	wikicat_Expatriate_footballers_in_England	8	7	1	0.14285714285714285
Bohol	wikicat_Provinces_of_the_Philippines	8	7	1	0.14285714285714285
Maksym_Levytskyi	wikicat_Ukrainian_expatriate_footballers	32	28	4	0.14285714285714285
Belfast	wikicat_Port_cities_and_towns_in_Northern_Ireland	8	7	1	0.14285714285714285
Sivaji_Ganesan	wikicat_Actors_in_Tamil_cinema	8	7	1	0.14285714285714285
Daigo_Kobayashi	wikicat_Japanese_expatriates_in_the_United_States	14008	12261	1747	0.14248429981241334
Kalusha_Bwalya	wikicat_People_from_Mufulira	16160	14148	2012	0.1422109132032796
Ronald_Arana	wikicat_Club_Destroyers_players	17079	14961	2118	0.14156807700020052
Pegah_F.C.	wikicat_Association_football_clubs_established_in_2002	105	92	13	0.14130434782608695
Peter_O'Donnell	wikicat_English_romantic_fiction_writers	14784	12971	1813	0.1397733405288721
50_Cent	wikicat_Aftermath_Entertainment_artists	16141	14163	1978	0.13965967662218456
Hillsborough_County,_Florida	wikicat_Counties_in_the_Tampa_Bay_Area	16968	14898	2070	0.13894482480869916
German_language	wikicat_Languages_of_Kazakhstan	99	87	12	0.13793103448275862
Pascal_Zuberbühler	wikicat_2006_FIFA_World_Cup_players	66	58	8	0.13793103448275862
Segundo_Castillo	wikicat_ESPOLI_footballers	91	80	11	0.1375
Ara_Hakobyan	wikicat_FC_Zimbru_Chișinău_players	15104	13285	1819	0.13692133985698154
Midge_Ure	wikicat_Scottish_guitarists	13858	12190	1668	0.1368334700574241
Neil_Jordan	wikicat_Irish_atheists	16613	14616	1997	0.1366310892172961
Montgomery_Clift	wikicat_Bisexual_actors	14863	13104	1759	0.13423382173382173
Rachel_Weisz	wikicat_People_of_Hungarian_descent	16900	14903	1997	0.13399986579883244
Captain_Beefheart	wikicat_American_sculptors	16861	14876	1985	0.13343640763646142
Umut_Kekıllı	wikicat_German_people_of_Turkish_descent	17	15	2	0.13333333333333333
Nicolás_Diez	wikicat_Everton_de_Viña_del_Mar_players	26	23	3	0.13043478260869565
Valberto_Amorim_dos_Santos	wikicat_Montedio_Yamagata_players	17212	15252	1960	0.12850773669027013
Great_Turkish_War	wikicat_Russo-Turkish_Wars	15262	13544	1718	0.12684583579444772
Jack_Pelter	wikicat_Canterbury_United_players	15446	13711	1735	0.12654073371745314
FK_Banat_Zrenjanin	wikicat_Football_clubs_in_Vojvodina	11830	10502	1328	0.12645210436107407
Dietmar_Hamann	wikicat_German_expatriates_in_England	15568	13824	1744	0.1261574074074074
Jack_Reynolds_(footballer_born_1881)	wikicat_Netherlands_national_football_team_managers	12733	11313	1420	0.1255193140634668
British_Columbia	wikicat_States_and_territories_established_in_1871	8310	7384	926	0.12540628385698807
Pim_Fortuyn_List	wikicat_Defunct_political_parties_in_the_Netherlands	14902	13246	1656	0.12501887362222558
Stephen_Hawking	wikicat_Theoretical_physicists	36	32	4	0.125
Aleksandar_Aleksandrov_(footballer_born_1975)	wikicat_Bulgarian_expatriates_in_Turkey	9	8	1	0.125
Stephen_Bywater	wikicat_Ipswich_Town_F.C._players	9	8	1	0.125
Sérgio_Araújo	wikicat_Grêmio_Foot-Ball_Porto_Alegrense_players	9	8	1	0.125
Bănel_Nicoliță	wikicat_UEFA_Euro_2008_players	27	24	3	0.125
Marvin_Minsky	wikicat_Harvard_University_alumni	9	8	1	0.125
Serge_Gainsbourg	wikicat_French_writers	9	8	1	0.125
Jean-Luc_Godard	wikicat_French_experimental_filmmakers	16680	14845	1835	0.12361064331424722
Abdus_Salam	wikicat_Pakistani_physicists	15414	13727	1687	0.12289648138704742
Jack_Cork	wikicat_Footballers_at_the_2012_Summer_Olympics	3166	2821	345	0.12229705778092875
Andy_Millen	wikicat_Kilmarnock_F.C._players	46	41	5	0.12195121951219512
Roy_Ashburn	wikicat_People_from_Long_Beach,_California	16048	14304	1744	0.12192393736017897
Liberal_Democrats	wikicat_Liberal_parties_in_the_United_Kingdom	12205	10885	1320	0.12126779972439136
Ernest_Gold_(composer)	wikicat_Austrian_film_score_composers	16352	14587	1765	0.12099814903681361
Sean_Flynn_(footballer)	wikicat_West_Bromwich_Albion_F.C._players	66	59	7	0.11864406779661017
Tacloban	wikicat_Cities_in_the_Philippines	13844	12380	1464	0.11825525040387722
Mao_Zedong	wikicat_Communist_rulers	16362	14639	1723	0.11769929640002733
Royal_Medal	wikicat_Biology_awards	38	34	4	0.11764705882352941
Serge_Gainsbourg	wikicat_20th-century_French_male_actors	87	78	9	0.11538461538461539
Armin_Veh	wikicat_German_expatriate_footballers	58	52	6	0.11538461538461539
Barak_Badash	wikicat_Football_players_from_Netanya	14642	13135	1507	0.1147316330414922
Paulo_Figueiredo	wikicat_2006_FIFA_World_Cup_players	108	97	11	0.1134020618556701
Radomir_Đalović	wikicat_Montenegrin_expatriates_in_Germany	14266	12824	1442	0.11244541484716157
Craig_Armstrong_(footballer)	wikicat_Burnley_F.C._players	119	107	12	0.11214953271028037
Thom_Yorke	wikicat_English_rock_singers	10	9	1	0.1111111111111111
Danilo_Sacramento	wikicat_Guarani_Futebol_Clube_players	10	9	1	0.1111111111111111
Parral_(footballer)	wikicat_Santa_Cruz_Futebol_Clube_players	10	9	1	0.1111111111111111
Raf_de_Gregorio	wikicat_National_Soccer_League_(Australia)_players	10	9	1	0.1111111111111111
Fernando_Varela_Ramos	wikicat_Spanish_people	10	9	1	0.1111111111111111
Hanover	wikicat_German_state_capitals	10	9	1	0.1111111111111111
Putrajaya	wikicat_Special_Economic_Zones	40	36	4	0.1111111111111111
Anne,_Princess_Royal	wikicat_People_from_Westminster	81	73	8	0.1095890410958904
Kotka	wikicat_Populated_places_established_in_1879	16038	14456	1582	0.1094355285002767
Stephen_Fry	wikicat_Rectors_of_the_University_of_Dundee	17248	15560	1688	0.10848329048843187
Portimonense_S.C.	wikicat_Association_football_clubs_established_in_1914	82	74	8	0.10810810810810811
The_New_School	wikicat_Educational_institutions_established_in_1919	155	140	15	0.10714285714285714
Nick_Cave	wikicat_Musicians_from_Melbourne	31	28	3	0.10714285714285714
Baraboo,_Wisconsin	wikicat_Micropolitan_areas_of_Wisconsin	10505	9499	1006	0.1059058848299821
Maria_Bello	wikicat_Lesbian_actresses	15363	13895	1468	0.10564951421374595
J._R._Reid	wikicat_Olympic_bronze_medalists_for_the_United_States	15778	14272	1506	0.1055213004484305
Luton	wikicat_Unitary_authority_districts_of_England	21	19	2	0.10526315789473684
Disney–ABC_Television_Group	wikicat_Walt_Disney_Company_subsidiaries	14294	12941	1353	0.10455142570125957
Takayuki_Hattori	wikicat_Japanese_film_score_composers	17132	15525	1607	0.10351046698872786
Lyndon_B._Johnson	wikicat_American_gun_control_advocates	15161	13745	1416	0.10301927973808658
Ryan_Mack	wikicat_Syracuse_Salty_Dogs_players	12851	11661	1190	0.10204956693251008
Romeo_Filipović	wikicat_NK_Karlovac_players	16721	15179	1542	0.10158771987614468
Xerez_CD	wikicat_Association_football_clubs_established_in_1947	316	287	29	0.10104529616724739
San_Jose_Earthquakes_(1974–88)	wikicat_Western_Soccer_Alliance_teams	13602	12358	1244	0.10066353778928629
Four_Tet	wikicat_Ableton_Live_users	15145	13762	1383	0.1004941142275832
Communist_Party_of_Germany	wikicat_Political_parties_in_the_Weimar_Republic	11	10	1	0.1
Peter_David	wikicat_Jewish_American_writers	33	30	3	0.1
Nouakchott	wikicat_Capitals_in_Africa	11	10	1	0.1
Västra_Götaland_County	wikicat_Provinces_of_Sweden	11	10	1	0.1
Jennifer_Lopez	wikicat_21st-century_actresses	22	20	2	0.1
Carmine_Coppola_(footballer)	wikicat_Taranto_F.C._1927_players	15300	13912	1388	0.09976998274870616
Bernard_Cornwell	wikicat_Alumni_of_the_University_of_London	11575	10538	1037	0.09840576959574872
New_Ireland_Province	wikicat_Islands_of_Papua_New_Guinea	13958	12712	1246	0.09801762114537445
Atlético_Celaya	wikicat_Football_clubs_in_Celaya	13458	12258	1200	0.09789525208027411
Narbonne	wikicat_Communes_of_Aude	15369	14001	1368	0.09770730662095564
Ville_Väisänen	wikicat_Bryne_FK_players	14253	12988	1265	0.09739759778256853
Roger_Ebert	wikicat_American_skeptics	293	267	26	0.09737827715355805
Manuel_Márquez_de_León_International_Airport	wikicat_Airports_in_Mexico	34	31	3	0.0967741935483871
James_Hetfield	wikicat_Baritones	17304	15780	1524	0.09657794676806084
Alfred_Tarski	wikicat_Computability_theorists	17202	15704	1498	0.09538970962812023
Ronald_Coase	wikicat_People_from_Brent_(London_borough)	16769	15315	1454	0.09493960169768201
Gosford_Park	wikicat_British_crime_films	15677	14322	1355	0.09460969138388493
Alex_Afonso	wikicat_Ituano_Futebol_Clube_players	47	43	4	0.09302325581395349
G._K._Chesterton	wikicat_Alumni_of_the_Slade_School_of_Art	11108	10177	931	0.09148079001670434
Nelson_Mandela	wikicat_South_African_humanitarians	14638	13415	1223	0.09116660454714871
Piermario_Morosini	wikicat_People_from_Bergamo	17349	15902	1447	0.09099484341592252
Kingdom_of_Hanover	wikicat_States_and_territories_established_in_1814	348	319	29	0.09090909090909091
Korean_War	wikicat_Wars_involving_Turkey	10866	9965	901	0.09041645760160562
Andreas_Glyniadakis	wikicat_New_Mexico_Thunderbirds_players	15745	14443	1302	0.09014747628609014
Dave_Mitchell_(footballer)	wikicat_Altay_S.K._footballers	4523	4152	371	0.08935452793834296
Sterling_Hayden	wikicat_People_from_Marin_County,_California	1413	1298	115	0.08859784283513097
Dorge_Kouemaha	wikicat_Gaziantepspor_footballers	62	57	5	0.08771929824561403
Roscoe_Arbuckle	wikicat_Male_actors_from_Kansas	16791	15442	1349	0.08735915036912317
U.S._Cremonese	wikicat_Association_football_clubs_established_in_1910	25	23	2	0.08695652173913043
John_Henry_Newman	wikicat_Beatified_people	11308	10407	901	0.08657634284616124
Pierce_Brosnan	wikicat_Irish_television_actors	16092	14813	1279	0.0863430770269358
Southport,_Queensland	wikicat_Coastal_towns_in_Queensland	15940	14677	1263	0.08605300810792396
Buckethead	wikicat_American_bluegrass_guitarists	15704	14467	1237	0.0855049422824359
Osamu_Tezuka	wikicat_Science_fiction_fans	7529	6938	591	0.08518304987027962
FIFA_World_Player_of_the_Year	wikicat_Awards_established_in_2001	16766	15454	1312	0.0848971140157888
Nicolae_Iorga	wikicat_Poets	13529	12471	1058	0.08483682142570764
Carlos_Navarro_Montoya	wikicat_Colombian_football_managers	15455	14258	1197	0.08395286856501613
Andrzej_Bledzewski	wikicat_Miedź_Legnica_players	13271	12246	1025	0.08370080026130981
Jonathan_Téhoué	wikicat_UJA_Alfortville_players	14321	13219	1102	0.0833648536197897
Virginia_Beach,_Virginia	wikicat_Populated_coastal_places_in_Virginia	13134	12126	1008	0.08312716476991588
Winston_Churchill	wikicat_Secretaries_of_State_for_the_Home_Department	14507	13415	1092	0.08140141632500932
Alkaline_Trio	wikicat_Epic_Records_artists	27	25	2	0.08
Gustavo_Biscayzacú	wikicat_Real_Jaén_footballers	2100	1947	153	0.07858243451463791
Gurban_Gurbanov	wikicat_Azerbaijani_football_managers	15619	14489	1130	0.07799019946166057
Republican_People's_Party_(Turkey)	wikicat_Secularist_political_parties	125	116	9	0.07758620689655173
Asrani	wikicat_Sindhi_people	15060	13981	1079	0.07717616765610472
Aarón_Ñíguez	wikicat_UD_Almería_footballers	28	26	2	0.07692307692307693
Luis_Flores_(basketball)	wikicat_Point_guards	28	26	2	0.07692307692307693
Maurice_Ross	wikicat_Scotland_B_international_footballers	14	13	1	0.07692307692307693
Matthew_Broderick	wikicat_American_musical_theatre_actors	56	52	4	0.07692307692307693
Daniel_Dennett	wikicat_American_non-fiction_writers	285	265	20	0.07547169811320754
Yago_Alonso-Fueyo_Sako	wikicat_Equatoguinean_expatriate_footballers	13771	12819	952	0.07426476324206256
Jeffrey_Jones	wikicat_Stage_actors	29	27	2	0.07407407407407407
Stephenie_Meyer	wikicat_Women_film_producers	13768	12819	949	0.07403073562680396
Zé_Ramalho	wikicat_Brazilian_guitarists	15246	14203	1043	0.07343518974864466
Sylvia_Plath	wikicat_American_diarists	12465	11633	832	0.07152067394481217
Émile_Mpenza	wikicat_Belgium_international_footballers	45	42	3	0.07142857142857142
Olubayo_Adefemi	wikicat_Olympic_footballers_of_Nigeria	15	14	1	0.07142857142857142
Robert_Rich_(musician)	wikicat_American_musicians	105	98	7	0.07142857142857142
Santa_Cruz_County,_Arizona	wikicat_Arizona_counties	14955	13959	996	0.07135181603266709
Michael_Hughes_(footballer)	wikicat_People_from_Larne	15202	14206	996	0.07011122061100944
Paul_Simon	wikicat_American_acoustic_guitarists	15981	14936	1045	0.06996518478843064
Queensland	wikicat_States_and_territories_of_Australia	46	43	3	0.06976744186046512
Bobby_(2006_film)	wikicat_Spanish-language_films	108	101	7	0.06930693069306931
Alan_Ladd	wikicat_Actors_who_committed_suicide	2639	2469	170	0.0688537869582827
Mircea_Rednic	wikicat_UEFA_Euro_1984_players	156	146	10	0.0684931506849315
Milovan_Milović	wikicat_Albanian_Superliga_players	16096	15070	1026	0.06808228268082282
Craig_Beattie	wikicat_Barnet_F.C._players	256	240	16	0.06666666666666667
Richard_Garcia	wikicat_Sydney_FC_players	64	60	4	0.06666666666666667
Carlos_Navarro_Montoya	wikicat_Colombian_expatriates_in_Chile	13832	12989	843	0.06490107013626915
Otto_Szabó	wikicat_Debreceni_VSC_players	116	109	7	0.06422018348623854
Pat_Morita	wikicat_Actors_from_California	83	78	5	0.0641025641025641
Julio_Cortázar	wikicat_Argentine_expatriates_in_France	16767	15758	1009	0.0640309683970047
FK_Radnik_Bijeljina	wikicat_Football_clubs_in_Republika_Srpska	15612	14683	929	0.06327044881836137
Valéry_Giscard_d'Estaing	wikicat_Lycée_Janson_de_Sailly_alumni	17	16	1	0.0625
Namco	wikicat_Companies_established_in_1955	14073	13254	819	0.061792666364870984
Ioan_Sabău	wikicat_Brescia_Calcio_players	69	65	4	0.06153846153846154
Senthil_(actor)	wikicat_All_India_Anna_Dravida_Munnetra_Kazhagam_politicians	14687	13849	838	0.060509784099935016
Serge_Gainsbourg	wikicat_French-language_writers	390	368	22	0.059782608695652176
Niagara_Falls,_Ontario	wikicat_Canadian_border_cities	15160	14305	855	0.05976931142957008
Dnipropetrovsk	wikicat_Populated_places_established_in_1776	2041	1926	115	0.05970924195223261
Michael_Atiyah	wikicat_Presidents_of_the_Royal_Society	71	67	4	0.05970149253731343
David_Lynch	wikicat_Screenwriters	18	17	1	0.058823529411764705
Borough_of_Brentwood	wikicat_Local_government_districts_of_the_East_of_England	18	17	1	0.058823529411764705
Anagennisi_Karditsa_F.C.	wikicat_Football_clubs_in_Thessaly	15167	14329	838	0.058482797124712126
Dorinel_Munteanu	wikicat_FC_Argeș_Pitești_managers	16253	15368	885	0.05758719416970328
Gerald_Ford	wikicat_American_lawyers	37	35	2	0.05714285714285714
Armin_Veh	wikicat_German_expatriates_in_Switzerland	15805	14952	853	0.05704922418405564
Alhassane_Issoufou	wikicat_Niger_international_footballers	75	71	4	0.056338028169014086
Vampeta	wikicat_2001_FIFA_Confederations_Cup_players	75	71	4	0.056338028169014086
Mahesh_Babu	wikicat_People_from_Chennai	19	18	1	0.05555555555555555
Dimba	wikicat_América_Futebol_Clube_(MG)_players	95	90	5	0.05555555555555555
Karl_Popper	wikicat_Austrian_agnostics	116	110	6	0.05454545454545454
Ludwig_Boltzmann	wikicat_Scientists_who_committed_suicide	15758	14958	800	0.05348308597406071
Fukuyama,_Hiroshima	wikicat_Populated_places_established_in_1619	14317	13597	720	0.052952857247922334
Marvin_Minsky	wikicat_American_mathematicians	20	19	1	0.05263157894736842
Yago_Alonso-Fueyo_Sako	wikicat_Recreativo_de_Huelva_footballers	20	19	1	0.05263157894736842
Legazpi,_Albay	wikicat_Cities_in_the_Philippines	11070	10519	551	0.052381405076528186
John_O'Rourke_(footballer)	wikicat_A.F.C._Bournemouth_players	61	58	3	0.05172413793103448
Chuck_Norris	wikicat_American_political_writers	509	484	25	0.05165289256198347
Liam_Neeson	wikicat_Irish_television_actors	15378	14635	743	0.05076870515886573
Stephen_Hawking	wikicat_Alumni_of_Trinity_Hall,_Cambridge	1862	1773	89	0.050197405527354765
Alfonso_Blanco_Antúnez	wikicat_Mexican_footballers	21	20	1	0.05
Gerry_Francis	wikicat_Tottenham_Hotspur_F.C._managers	15977	15224	753	0.0494613767735155
Yuriy_Moroz	wikicat_Maccabi_Jaffa_F.C._players	10699	10198	501	0.04912727985879584
Oscar_Hammerstein_II	wikicat_American_musical_theatre_librettists	15917	15176	741	0.04882709541381128
Dessau	wikicat_World_Heritage_Sites_in_Germany	43	41	2	0.04878048780487805
Nico_Claesen	wikicat_1990_FIFA_World_Cup_players	43	41	2	0.04878048780487805
Abraham_Lincoln	wikicat_Assassinated_American_people	130	124	6	0.04838709677419355
Abdel_Sattar_Sabry	wikicat_People_from_Cairo	15466	14761	705	0.04776099180272339
Mirko_Plantić	wikicat_NK_Međimurje_players	13425	12821	604	0.04711020981202714
Thomas_Jefferson	wikicat_State_governors_of_the_United_States	89	85	4	0.047058823529411764
Terence_Tao	wikicat_People_from_Los_Angeles,_California	45	43	2	0.046511627906976744
Clint_Marcelle	wikicat_Rio_Ave_F.C._players	430	411	19	0.046228710462287104
Evgeny_Yarovenko	wikicat_Olympic_medalists_in_football	46	44	2	0.045454545454545456
Legazpi,_Albay	wikicat_Cities_in_Luzon	7430	7107	323	0.04544814971155199
Burhan_Eşer	wikicat_Gaziantep_B.B._footballers	15743	15059	684	0.04542134271864002
Jacques_Chirac	wikicat_Lycée_Carnot_alumni	16269	15575	694	0.044558587479935796
César_Award	wikicat_French_awards	47	45	2	0.044444444444444446
Syarhey_Kuznyatsow	wikicat_Belarusian_footballers	47	45	2	0.044444444444444446
Gustav_Kirchhoff	wikicat_Fellows_of_the_Royal_Society_of_Edinburgh	142	136	6	0.04411764705882353
Uladzimir_Karytska	wikicat_Belarusian_expatriate_footballers	24	23	1	0.043478260869565216
Susan_Sontag	wikicat_Photography_critics	16394	15739	655	0.04161636698646674
University_of_Strasbourg	wikicat_Educational_institutions_established_in_2009	13084	12578	506	0.04022897121958976
Kyra_Sedgwick	wikicat_Jewish_actors	26	25	1	0.04
Amman_Civil_Airport	wikicat_Airports_in_Jordan	14511	13953	558	0.03999139969898947
Sewickley,_Pennsylvania	wikicat_Pennsylvania_populated_places_on_the_Ohio_River	11183	10760	423	0.03931226765799257
G._K._Chesterton	wikicat_British_World_War_I_poets	15651	15089	562	0.03724567565776393
Queen_Beatrix_International_Airport	wikicat_Airports_in_the_Netherlands	16008	15446	562	0.03638482455004532
Miklós_Fehér	wikicat_Association_football_players_who_died_while_playing	314	303	11	0.036303630363036306
Fernando_Fernández_Escribano	wikicat_Andalusian_footballers	29	28	1	0.03571428571428571
Maggie_Gyllenhaal	wikicat_American_people_of_Swedish_descent	3359	3244	115	0.03545006165228114
Charlie_Chaplin	wikicat_Slapstick_comedians	15822	15293	529	0.0345909893415288
Bradley_Thomas_(footballer)	wikicat_Concord_Rangers_F.C._players	14802	14312	490	0.03423700391280045
City_of_Canada_Bay	wikicat_Local_government_areas_in_Sydney	15016	14534	482	0.03316361634787395
Anthony_Eden	wikicat_British_Secretaries_of_State_for_Foreign_and_Commonwealth_Affairs	13693	13276	417	0.0314100632720699
Milan_Purović	wikicat_OFK_Beograd_players	33	32	1	0.03125
Kilmarnock_F.C.	wikicat_Defunct_Scottish_rugby_union_clubs	15423	14966	457	0.03053588133101697
Debbie_Reynolds	wikicat_American_musical_theatre_actresses	34	33	1	0.030303030303030304
Thomas_Bernhard	wikicat_People_from_Heerlen	15619	15162	457	0.03014114232950798
George_Papandreou	wikicat_Greek_politicians	16344	15866	478	0.030127316273793017
Roger_Ebert	wikicat_Film_theorists	578	563	15	0.02664298401420959
Nicolas_Anelka	wikicat_Converts_to_Islam_from_Christianity	16803	16370	433	0.02645082467929139
Anton_Chekhov	wikicat_Russian_short_story_writers	15273	14885	388	0.026066509909304668
Jimmy_Ghaichem	wikicat_Buxton_F.C._players	201	196	5	0.025510204081632654
Philadelphia	wikicat_Populated_places_established_in_1682	14330	13974	356	0.0254758837841706
Lee_Chapman	wikicat_Chamois_Niortais_F.C._players	15581	15197	384	0.02526814502862407
Eduardo_Costa	wikicat_Club_de_Regatas_Vasco_da_Gama_players	122	119	3	0.025210084033613446
Mario_Cáceres	wikicat_Lobos_de_la_BUAP_footballers	14887	14528	359	0.024710903083700442
Lee_Hyung-sang	wikicat_Daejeon_Citizen_FC_players	15015	14654	361	0.02463491196942814
New_York_metropolitan_area	wikicat_Metropolitan_areas_of_Pennsylvania	15141	14778	363	0.024563540397888755
Marcel_Domingo	wikicat_AC_Arles-Avignon_players	459	448	11	0.024553571428571428
Jarosław	wikicat_Cities_and_towns_in_Podkarpackie_Voivodeship	13932	13606	326	0.02396001763927679
Daniel_Guerrero_Gómez	wikicat_UE_Figueres_footballers	16216	15845	371	0.023414326285894602
Jane_Wyman	wikicat_American_women	177	173	4	0.023121387283236993
Little_Rock,_Arkansas	wikicat_Cities_in_Pulaski_County,_Arkansas	13197	12908	289	0.02238921599008367
Pim_Fortuyn_List	wikicat_Political_parties_disestablished_in_2007	142	139	3	0.02158273381294964
Carl_Dickinson	wikicat_Blackpool_F.C._players	50	49	1	0.02040816326530612
Fort_Lauderdale_Strikers	wikicat_Soccer_clubs_in_Miami,_Florida	13477	13209	268	0.020289196759784994
Bruno_Alves	wikicat_Footballers_at_the_2004_Summer_Olympics	53	52	1	0.019230769230769232
George_Papandreou	wikicat_Government_ministers_of_Greece	16882	16564	318	0.019198261289543588
Nenad_Stojanović	wikicat_K.R.C._Genk_players	438	430	8	0.018604651162790697
Dennis_Rodman	wikicat_San_Antonio_Spurs_players	498	489	9	0.018404907975460124
Mustafa_Kemal_Atatürk	wikicat_Inventors_of_writing_systems	14093	13839	254	0.018353927306886335
Mylène_Farmer	wikicat_Francophone_Quebec_people	15331	15066	265	0.017589273861675296
Captain_Beefheart	wikicat_21st-century_American_painters	1797	1767	30	0.01697792869269949
Julianne_Moore	wikicat_American_people_of_Scottish_descent	61	60	1	0.016666666666666666
Université_libre_de_Bruxelles	wikicat_Educational_institutions_established_in_1834	13965	13739	226	0.01644952325496761
Walt_Disney	wikicat_American_people_of_French_descent	66	65	1	0.015384615384615385
Mike_Myers	wikicat_People_from_Ontario	4315	4253	62	0.014577944980014107
Gary_Barlow	wikicat_People_from_Cheshire	16433	16204	229	0.014132313009133547
Dick_Van_Dyke	wikicat_Musicians_from_Illinois	17301	17068	233	0.013651277243965315
Thom_Yorke	wikicat_People_educated_at_Abingdon_School	14197	14027	170	0.012119483852570043
Jalandhar	wikicat_Cities_and_towns_in_Punjab,_India	9157	9053	104	0.011487904562023638
Romy_Schneider	wikicat_Actresses_from_Vienna	15336	15186	150	0.009877518767285659
Valencia_BC	wikicat_Basketball_clubs_established_in_1986	428	424	4	0.009433962264150943
Woodrow_Wilson	wikicat_People_from_Staunton,_Virginia	16615	16466	149	0.009048949350176121
Dubai_International_Airport	wikicat_Airports_in_the_United_Arab_Emirates	12529	12427	102	0.008207934336525308
Carlos_María_Morales	wikicat_Deportivo_Toluca_F.C._footballers	125	124	1	0.008064516129032258
Roberto_Nurse	wikicat_Panamanian_expatriate_footballers	139	138	1	0.007246376811594203
Laredo,_Texas	wikicat_Populated_places_established_in_1755	13694	13603	91	0.006689700801293832
Carlo_Azeglio_Ciampi	wikicat_Action_Party_(Italy)_politicians	16218	16121	97	0.0060169964642391915
Marcos_Alonso_Peña	wikicat_Málaga_CF_managers	14795	14708	87	0.005915148218656513
Ljungskile_SK	wikicat_Allsvenskan_clubs	16190	16097	93	0.005777474063490091
Jules_Vandooren	wikicat_CS_Sedan_Ardennes_managers	13236	13175	61	0.004629981024667932
Mark_Owen	wikicat_Musicians_from_Greater_Manchester	16585	16513	72	0.004360201053715255
Benjamin_Fondane	wikicat_People_from_Iaşi	15278	15225	53	0.0034811165845648603
Edward_L._Cahn	wikicat_Film_directors_from_New_York_City	678	676	2	0.0029585798816568047
Modesto,_California	wikicat_Cities_in_Stanislaus_County,_California	15919	15873	46	0.002898002898002898
Stephen_Fry	wikicat_People_educated_at_Uppingham_School	16365	16320	45	0.0027573529411764708
Shirley_Jones	wikicat_Actresses_from_Pittsburgh,_Pennsylvania	15960	15919	41	0.0025755386644889756
Lucky_Idahor	wikicat_People_from_Benin_City	16188	16151	37	0.002290879821682868
Ronald_Coase	wikicat_21st-century_English_writers	14075	14049	26	0.0018506655277955727
Liberal_Party_(UK)	wikicat_Political_parties_disestablished_in_1988	15200	15182	18	0.0011856145435384007
Douglas_Engelbart	wikicat_Xerox_people	13260	13245	15	0.0011325028312570782
Charles_S._Dutton	wikicat_Actors_from_Maryland	16064	16051	13	0.0008099183851473428
Curd_Jürgens	wikicat_German_people_of_French_descent	6101	6100	1	0.0001639344262295082
Siahkal_County	wikicat_Counties_of_Gilan_Province	1	1	0	0.0
André_Luiz_Moreira	wikicat_Ligue_1_players	1	1	0	0.0
Fausto_Lourenço	wikicat_Expatriate_footballers_in_Cyprus	2	2	0	0.0
Sergio_Volpi	wikicat_Serie_B_footballers	1	1	0	0.0
Cédric_Roussel	wikicat_Expatriate_footballers_in_Russia	2	2	0	0.0
Ethiopia	wikicat_Member_states_of_the_United_Nations	1	1	0	0.0
Jeffrey_Jones	wikicat_20th-century_American_male_actors	1	1	0	0.0
Świnoujście	wordnet_administrative_district_108491826	2	2	0	0.0
Elmore_Leonard	wikicat_American_male_novelists	1	1	0	0.0
Fernando_Navarro	wikicat_Living_people	1	1	0	0.0
Kevin_Miller_(footballer)	wikicat_Bristol_Rovers_F.C._players	1	1	0	0.0
California_Institute_of_Technology	wikicat_Universities_and_colleges_in_Los_Angeles_County,_California	1	1	0	0.0
Ely_Thadeu	wikicat_Living_people	1	1	0	0.0
Daniele_De_Vezze	wikicat_Serie_B_footballers	1	1	0	0.0
Bozhidar_Iskrenov	wikicat_Bulgaria_international_footballers	2	2	0	0.0
Sanjay_Dutt	wikicat_Male_actors_in_Hindi_cinema	2	2	0	0.0
August_Wilhelm_von_Hofmann	wordnet_scientist_110560637	1	1	0	0.0
Margaret_Sullavan	wikicat_Women	1	1	0	0.0
Aalen	wordnet_location_100027167	1	1	0	0.0
Ross_Macdonald	wikicat_20th-century_American_novelists	1	1	0	0.0
Brisbane	wordnet_site_108651247	1	1	0	0.0
Curly_Howard	wikicat_American_male_film_actors	2	2	0	0.0
Amman	wordnet_administrative_district_108491826	1	1	0	0.0
Gurban_Gurbanov	wikicat_FC_Baltika_Kaliningrad_players	1	1	0	0.0
Meryl_Streep	wikicat_21st-century_actors	2	2	0	0.0
New_Rochelle,_New_York	wikicat_Populated_coastal_places_in_New_York	1	1	0	0.0
Nathan_Ashton	wikicat_Living_people	1	1	0	0.0
Gerard_Butler	wordnet_person_100007846	1	1	0	0.0
Herbert_Ross	wikicat_American_people	1	1	0	0.0
Boston	wikicat_Cities_in_Massachusetts	1	1	0	0.0
Tommy_Tynan	wikicat_Newport_County_A.F.C._players	1	1	0	0.0
Liivo_Leetma	wikicat_JK_Nõmme_Kalju_players	1	1	0	0.0
Düsseldorf	wikicat_Cities_in_Germany	1	1	0	0.0
Marco_Delvecchio	wikicat_Living_people	1	1	0	0.0
Otto_Szabó	wikicat_Nemzeti_Bajnokság_I_players	17	17	0	0.0
Frederik_Pohl	wikicat_20th-century_American_novelists	1	1	0	0.0
Gahar_Zagros_F.C.	wordnet_club_108227214	1	1	0	0.0
Tonga	wikicat_Islands_of_Oceania	1	1	0	0.0
North_Khorasan_Province	wikicat_Subdivisions_of_Iran	1	1	0	0.0
Peru	wikicat_Countries	1	1	0	0.0
Brian_O'Nolan	wikicat_Writers	1	1	0	0.0
Uganda	wikicat_States_and_territories_established_in_1962	4	4	0	0.0
Mia_Farrow	wikicat_21st-century_actors	1	1	0	0.0
United_Arab_Emirates	wikicat_Member_states_of_the_United_Nations	1	1	0	0.0
Amherst_College	wikicat_Private_universities_and_colleges_in_the_United_States	1	1	0	0.0
Fort-de-France	wordnet_commune_108541609	1	1	0	0.0
Budapest	wikicat_Cities_with_millions_of_inhabitants	1	1	0	0.0
Alameda_County,_California	wikicat_Populated_places_established_in_1853	1	1	0	0.0
Inverness	wikicat_Port_cities_and_towns_in_Scotland	3	3	0	0.0
S.P.A.L._2013	wikicat_Serie_B_clubs	1	1	0	0.0
St._Joseph_County,_Michigan	wikicat_Michigan_counties	1	1	0	0.0
Sonic_Team	wikicat_Video_game_development_companies	1	1	0	0.0
Maryland	wordnet_administrative_district_108491826	1	1	0	0.0
Hertha_BSC	wikicat_Football_clubs_in_Germany	1	1	0	0.0
Ronald_Colman	wikicat_Actors	1	1	0	0.0
Aitor_Ocio	wikicat_Spain_youth_international_footballers	1	1	0	0.0
Chile	wordnet_country_108544813	1	1	0	0.0
Mike_Ambersley	wikicat_American_soccer_players	3	3	0	0.0
East_Haddam,_Connecticut	wordnet_administrative_district_108491826	1	1	0	0.0
Artem_Starhorodskyi	wikicat_SC_Tavriya_Simferopol_players	1	1	0	0.0
Bono	wikicat_Rock_singers	1	1	0	0.0
Barcelona	wikicat_Roman_sites_in_Spain	1	1	0	0.0
Stacie_Orrico	wordnet_artist_109812338	1	1	0	0.0
Roque_Santa_Cruz	wikicat_Living_people	1	1	0	0.0
Bolu	wikicat_Ancient_Greek_sites_in_Turkey	1	1	0	0.0
Ertan_Demiri	wikicat_Expatriate_footballers_in_Saudi_Arabia	3	3	0	0.0
Watertown,_Massachusetts	wikicat_Cities_in_Massachusetts	1	1	0	0.0
Jimmy_Ghaichem	wikicat_Scarborough_Athletic_F.C._players	1	1	0	0.0
Agnes_Moorehead	wikicat_American_actresses	1	1	0	0.0
Daniel_Dennett	wikicat_Skeptics	11	11	0	0.0
Gmina_Inowrocław	wordnet_administrative_district_108491826	1	1	0	0.0
Miran_Burgič	wikicat_Slovenian_footballers	1	1	0	0.0
KHL_Medveščak_Zagreb	wordnet_hockey_team_108080386	1	1	0	0.0
Guillermo_La_Rosa	wikicat_Living_people	1	1	0	0.0
Jamie_Lee_Curtis	wordnet_person_100007846	1	1	0	0.0
Marcos_Paulo_Alves	wikicat_Brazilian_expatriate_footballers	1	1	0	0.0
Roger_Hodgson	wordnet_artist_109812338	1	1	0	0.0
Dani_Chigou	wikicat_Liga_I_players	1	1	0	0.0
Osnabrück	wikicat_Districts_of_Lower_Saxony	1	1	0	0.0
Dietmar_Hamann	wikicat_German_footballers	1	1	0	0.0
Esmeraldas,_Ecuador	wikicat_Populated_coastal_places_in_Ecuador	1	1	0	0.0
Alex_Mathie	wikicat_The_Football_League_players	1	1	0	0.0
Brno	wikicat_Cities_and_towns_in_the_Czech_Republic	1	1	0	0.0
Leonid_Hurwicz	wikicat_Polish_people	2	2	0	0.0
Civic_Platform	wordnet_party_108256968	1	1	0	0.0
Greene_County,_Pennsylvania	wikicat_Counties_of_Appalachia	2	2	0	0.0
Slovenia	wikicat_Member_states_of_NATO	1	1	0	0.0
Louis_XV_of_France	wikicat_Smallpox_survivors	1	1	0	0.0
José_Veiga	wikicat_Primeira_Liga_players	1	1	0	0.0
Woking_F.C.	wikicat_Association_football_clubs_established_in_1889	1	1	0	0.0
Natasha_Richardson	wikicat_English_film_actors	1	1	0	0.0
Sociedade_Esportiva_Palmeiras	wordnet_club_108227214	1	1	0	0.0
Jonathan_Téhoué	wikicat_SC_Bastia_players	4	4	0	0.0
Carlos_Alberto_de_Jesus	wikicat_Living_people	1	1	0	0.0
George_W._Bush	wikicat_American_people_of_German_descent	1	1	0	0.0
Burundi	wikicat_Bantu_countries_and_territories	1	1	0	0.0
Ludington,_Michigan	wikicat_County_seats_in_Michigan	1	1	0	0.0
Bernard_Cornwell	wikicat_English-language_writers	1	1	0	0.0
Aleksandar_Komadina	wikicat_Russian_Premier_League_players	1	1	0	0.0
The_Specials	wikicat_English_New_Wave_musical_groups	1	1	0	0.0
Piranshahr_County	wordnet_administrative_district_108491826	1	1	0	0.0
Abia_State	wikicat_States_of_Nigeria	1	1	0	0.0
Trabzon	wikicat_Ancient_Greek_cities	1	1	0	0.0
Jonathan_Walters	wikicat_Living_people	1	1	0	0.0
Arnhem	wikicat_Provincial_capitals_of_the_Netherlands	1	1	0	0.0
Brazil	wikicat_Member_states_of_the_United_Nations	1	1	0	0.0
Ottoman_Empire	wikicat_Former_empires	1	1	0	0.0
Atlético_Huila	wikicat_Association_football_clubs_established_in_1990	1	1	0	0.0
Quentin_Tarantino	wikicat_American_screenwriters	1	1	0	0.0
Pantheon-Sorbonne_University	wikicat_Universities_in_Paris	2	2	0	0.0
Tony_Curtis	wikicat_Jewish_American_male_actors	5	5	0	0.0
Tan_Son_Nhat_International_Airport	wordnet_airport_102692232	1	1	0	0.0
Jan_Budtz	wikicat_The_Football_League_players	1	1	0	0.0
FC_Schalke_04	wordnet_club_108227214	1	1	0	0.0
Richard_Rorty	wordnet_philosopher_110423589	1	1	0	0.0
Leipzig	wikicat_University_towns_in_Germany	1	1	0	0.0
Kotka	wordnet_area_108497294	6	6	0	0.0
Bilbao	wikicat_Port_cities_and_towns_on_the_Spanish_Atlantic_coast	1	1	0	0.0
David_Hume	wikicat_Political_philosophers	4	4	0	0.0
Zlatko_Yankov	wikicat_PFC_Lokomotiv_Sofia_players	1	1	0	0.0
South_Derbyshire	wikicat_Districts_of_England	1	1	0	0.0
Locarno	wikicat_Municipalities_of_Switzerland	1	1	0	0.0
Ville_Väisänen	wikicat_Living_people	1	1	0	0.0
Anjelica_Huston	wikicat_American_actors	1	1	0	0.0
Kremenchuk	wikicat_Cities_in_Poltava_Oblast	1	1	0	0.0
Stephen_King	wikicat_American_novelists	2	2	0	0.0
Grammy_Award	wikicat_Music_awards	1	1	0	0.0
FC_Shakhtar_Donetsk	wordnet_club_108227214	1	1	0	0.0
Hibernian_F.C.	wikicat_Scottish_Football_League_teams	1	1	0	0.0
Argentina	wikicat_Spanish-speaking_countries_and_territories	1	1	0	0.0
Guy_Feutchine	wikicat_Cameroonian_expatriate_footballers	2	2	0	0.0
Allan_Michaelsen	wikicat_Danish_footballers	1	1	0	0.0
Cold_Turkey_(film)	wordnet_movie_106613686	1	1	0	0.0
Syarhey_Kuznyatsow	wikicat_Living_people	1	1	0	0.0
Bath,_Maine	wikicat_Cities_in_Maine	1	1	0	0.0
Montrose_F.C.	wikicat_Football_clubs_in_Scotland	1	1	0	0.0
Canton,_Ohio	wikicat_Cities_in_Ohio	1	1	0	0.0
University_of_Leeds	wikicat_Universities_in_the_United_Kingdom	1	1	0	0.0
Peru_national_football_team	wordnet_football_team_108080025	1	1	0	0.0
Belgium	wikicat_Member_states_of_NATO	1	1	0	0.0
Ben_Davis_(basketball)	wikicat_American_expatriate_basketball_people_in_Spain	1	1	0	0.0
Kingdom_of_Bavaria	wordnet_country_108544813	1	1	0	0.0
Amy_LePeilbet	wikicat_Women	1	1	0	0.0
United_Arab_Emirates	wikicat_Countries	1	1	0	0.0
F.B.C._Unione_Venezia	wikicat_Football_clubs_in_Veneto	1	1	0	0.0
Jane_Murfin	wikicat_American_film_directors	1	1	0	0.0
Ihor_Zhabchenko	wikicat_Ukrainian_Premier_League_players	1	1	0	0.0
Sheffield_Wednesday_F.C.	wordnet_club_108227214	1	1	0	0.0
Mersch	wikicat_Communes_of_Luxembourg	1	1	0	0.0
Syarhey_Kuznyatsow	wikicat_FC_Arsenal_Kyiv_players	1	1	0	0.0
Nicolás_Diez	wikicat_Living_people	1	1	0	0.0
Steve_Book	wikicat_Living_people	1	1	0	0.0
Erik_Edman	wikicat_Living_people	1	1	0	0.0
Yemen	wikicat_Member_states_of_the_United_Nations	1	1	0	0.0
Seol_Ki-hyeon	wikicat_Incheon_United_FC_players	2	2	0	0.0
Matías_Masiero	wikicat_Serie_B_footballers	2	2	0	0.0
Laos	wikicat_Southeast_Asian_countries	1	1	0	0.0
Sligo	wikicat_County_towns_in_the_Republic_of_Ireland	1	1	0	0.0
Union_of_Democrats_for_the_Republic	wordnet_party_108256968	1	1	0	0.0
Nicaragua	wikicat_Countries_in_Central_America	1	1	0	0.0
Halmahera	wikicat_Maluku_Islands	1	1	0	0.0
Atli_Eðvaldsson	wikicat_Bundesliga_players	1	1	0	0.0
Lausanne	wikicat_Populated_places_on_Lake_Geneva	1	1	0	0.0
Eduardo_Ratinho	wikicat_Living_people	1	1	0	0.0
Jean-Emmanuel_Effa_Owona	wikicat_Cameroon_international_footballers	1	1	0	0.0
Andrzej_Bledzewski	wikicat_Polish_footballers	1	1	0	0.0
Tivoli,_Lazio	wikicat_Cities_and_towns_in_Lazio	1	1	0	0.0
Malaysia	wikicat_Member_states_of_the_United_Nations	1	1	0	0.0
Nicaragua	wikicat_Countries	1	1	0	0.0
Anouk_Aimée	wikicat_People_from_Paris	1	1	0	0.0
East_Timor	wordnet_country_108544813	1	1	0	0.0
Corey_Feldman	wikicat_American_male_film_actors	1	1	0	0.0
Rome	wikicat_Cities_and_towns_in_Italy	1	1	0	0.0
Carrie_Fisher	wikicat_Actors	1	1	0	0.0
Chhunly_Pagenburg	wikicat_Living_people	1	1	0	0.0
Mvondo_Atangana	wikicat_Living_people	1	1	0	0.0
Poland	wikicat_Countries_in_Europe	1	1	0	0.0
Senegal	wikicat_Countries	1	1	0	0.0
Île-de-France	wordnet_region_108630039	1	1	0	0.0
Seoul	wikicat_Cities_with_millions_of_inhabitants	1	1	0	0.0
University_at_Buffalo,_The_State_University_of_New_York	wikicat_Schools_of_informatics	1	1	0	0.0
Gene_Wilder	wikicat_American_people	1	1	0	0.0
Chalon-sur-Saône	wordnet_commune_108541609	1	1	0	0.0
Nélson_Marcos	wikicat_S.L._Benfica_footballers	1	1	0	0.0
Vijay_(actor)	wikicat_Indian_male_film_actors	1	1	0	0.0
SC_Tavriya_Simferopol	wikicat_Association_football_clubs_disestablished_in_2014	1	1	0	0.0
Belize_City	wikicat_Port_cities	1	1	0	0.0
Newton,_Massachusetts	wordnet_administrative_district_108491826	1	1	0	0.0
Jean_Harlow	wikicat_Actors	1	1	0	0.0
Helsingborg	wikicat_Port_cities_in_Sweden	1	1	0	0.0
Republic_of_Ireland	wikicat_English-speaking_countries_and_territories	2	2	0	0.0
Kloten	wikicat_Cities_in_Switzerland	1	1	0	0.0
University_of_California,_Berkeley	wordnet_university_108286569	1	1	0	0.0
Keith_Jarrett	wordnet_artist_109812338	1	1	0	0.0
Carlos_Navarro_Montoya	wikicat_Colombia_international_footballers	1	1	0	0.0
Friedrich_Heinrich_Jacobi	wikicat_18th-century_philosophers	3	3	0	0.0
Lebanon	wikicat_Member_states_of_the_Organisation_of_Islamic_Cooperation	1	1	0	0.0
Dundee_F.C.	wikicat_Scottish_Premier_League_teams	1	1	0	0.0
Eastern_Region_(Ghana)	wordnet_administrative_district_108491826	1	1	0	0.0
Mario_Cáceres	wikicat_Expatriate_footballers_in_Greece	1	1	0	0.0
Paul_Simpson_(footballer)	wikicat_Premier_League_players	1	1	0	0.0
Quebec_Liberal_Party	wikicat_Political_parties_in_Canada	1	1	0	0.0
Pavel_Kirylchyk	wikicat_FC_Kairat_players	2	2	0	0.0
Paul_Bastock	wikicat_People_from_Royal_Leamington_Spa	1	1	0	0.0
Viggo_Mortensen	wikicat_Actors	1	1	0	0.0
South_Carolina	wikicat_Southern_United_States	2	2	0	0.0
Istria_County	wordnet_administrative_district_108491826	1	1	0	0.0
Mario_Regueiro	wikicat_Superleague_Greece_players	1	1	0	0.0
South_East_England	wordnet_region_108630039	1	1	0	0.0
Lemar	wordnet_artist_109812338	1	1	0	0.0
Tom_Skerritt	wordnet_person_100007846	1	1	0	0.0
Katie_Holmes	wikicat_Women	1	1	0	0.0
Vanuatu	wikicat_English-speaking_countries_and_territories	2	2	0	0.0
Doti_District	wordnet_district_108552138	1	1	0	0.0
Kaunas	wikicat_Cities_in_Lithuania	1	1	0	0.0
Richard_Francis-Bruce	wikicat_Living_people	1	1	0	0.0
Itay_Shechter	wikicat_Living_people	1	1	0	0.0
Dewsbury	wikicat_Towns_in_West_Yorkshire	1	1	0	0.0
Christopher_Guest	wikicat_American_people	1	1	0	0.0
Gottlob_Frege	wikicat_German_philosophers	1	1	0	0.0
Rabat	wordnet_administrative_district_108491826	1	1	0	0.0
Spirits_of_the_Dead	wordnet_movie_106613686	1	1	0	0.0
Pacific_Ocean	wordnet_ocean_109376198	1	1	0	0.0
Admir_Bilibani	wikicat_FC_Aarau_players	2	2	0	0.0
Rafael_Carlos_Santacruz	wikicat_Segunda_División_footballers	1	1	0	0.0
Fernando_Alves_Santa_Clara	wikicat_Living_people	1	1	0	0.0
Samuel_R._Delany	wikicat_Writers	1	1	0	0.0
Havana	wikicat_Capitals_in_Central_America	1	1	0	0.0
Colorado_Rapids	wikicat_Soccer_clubs_in_the_United_States	1	1	0	0.0
Shandong	wikicat_Administrative_divisions_of_China	1	1	0	0.0
Pablo_Aimar	wikicat_Primera_División_Argentina_players	1	1	0	0.0
Lee_Johnson_(footballer)	wikicat_Living_people	1	1	0	0.0
Graham_Arnold	wikicat_Australian_soccer_players	1	1	0	0.0
Fred_Zinnemann	wikicat_American_film_directors	1	1	0	0.0
Hugo_Award	wikicat_American_awards	1	1	0	0.0
Luis_Fernando_Espindola	wikicat_Living_people	1	1	0	0.0
Nkana_F.C.	wordnet_club_108227214	1	1	0	0.0
Géza_Kalocsay	wikicat_Hungarian_footballers	2	2	0	0.0
Bechara_Oliveira	wikicat_Brazilian_footballers	1	1	0	0.0
Phil_Charnock	wikicat_Football_Conference_players	1	1	0	0.0
Kang_Chul	wikicat_South_Korean_footballers	2	2	0	0.0
Eastern_Highlands_Province	wikicat_Provinces_of_Papua_New_Guinea	1	1	0	0.0
Pori	wordnet_municipality_108626283	1	1	0	0.0
Courteney_Cox	wikicat_American_film_actresses	1	1	0	0.0
Zoran_Milinković_(footballer)	wikicat_Serbian_footballers	1	1	0	0.0
Westlake_Village,_California	wikicat_Incorporated_cities_and_towns_in_California	1	1	0	0.0
Isabella_II_of_Spain	wikicat_Princes_of_Asturias	1	1	0	0.0
Daphne_du_Maurier	wikicat_Writers	1	1	0	0.0
Bernie_Mac	wikicat_20th-century_American_male_actors	1	1	0	0.0
Swindon_Town_F.C.	wikicat_Southern_Football_League_clubs	1	1	0	0.0
Marco_Gebhardt	wikicat_Living_people	1	1	0	0.0
Shelley_Winters	wikicat_American_actresses	1	1	0	0.0
Ann_Sothern	wikicat_Women	1	1	0	0.0
Miran_Burgič	wikicat_Living_people	1	1	0	0.0
Juan_José_Borrelli	wikicat_Living_people	1	1	0	0.0
Walid_Atta	wikicat_Allsvenskan_players	1	1	0	0.0
Fleetwood_Town_F.C.	wikicat_Northern_Premier_League_clubs	1	1	0	0.0
Pierre_Trudeau	wikicat_French-Canadian_people	1	1	0	0.0
Dick_Van_Dyke	wikicat_American_male_film_actors	1	1	0	0.0
Edet_Otobong	wikicat_Cameroonian_expatriate_footballers	2	2	0	0.0
Vancouver_Island	wikicat_Islands_of_the_Pacific_Ocean	2	2	0	0.0
Balkans	wordnet_cape_109233715	1	1	0	0.0
Dublin	wikicat_Populated_coastal_places_in_the_Republic_of_Ireland	2	2	0	0.0
Cambodia	wikicat_Member_states_of_the_Association_of_Southeast_Asian_Nations	1	1	0	0.0
Comoros	wikicat_Countries	1	1	0	0.0
Marek_Motyka	wikicat_Norwegian_Premier_League_players	3	3	0	0.0
Mahesh_Manjrekar	wikicat_Indian_film_producers	1	1	0	0.0
Ricardo_Rocha_(Portuguese_footballer)	wikicat_Portugal_international_footballers	4	4	0	0.0
Adana	wikicat_Ancient_Greek_sites_in_Turkey	1	1	0	0.0
Alphonse_Tchami	wikicat_Living_people	1	1	0	0.0
Jules_Vandooren	wikicat_Association_football_defenders	2	2	0	0.0
Filmfare_Awards_South	wikicat_Filmfare_Awards	2	2	0	0.0
UD_Melilla	wikicat_Football_clubs_in_Spain	1	1	0	0.0
Recklinghausen	wikicat_Cities_in_North_Rhine-Westphalia	1	1	0	0.0
Geelong	wikicat_Cities_in_Australia	1	1	0	0.0
Toowoomba	wikicat_Populated_places_in_Queensland	2	2	0	0.0
Salem,_Virginia	wikicat_Cities_in_Virginia	1	1	0	0.0
War_of_the_Sixth_Coalition	wikicat_Wars_involving_the_United_Kingdom	2	2	0	0.0
New_Brunswick	wordnet_district_108552138	1	1	0	0.0
Marius_Niculae	wikicat_Expatriate_footballers_in_Greece	1	1	0	0.0
Adam_Strachan	wikicat_Living_people	1	1	0	0.0
Harvey_Keitel	wikicat_American_television_actors	2	2	0	0.0
Stuart_Fleetwood	wikicat_Football_Conference_players	3	3	0	0.0
Masovian_Voivodeship	wordnet_administrative_district_108491826	1	1	0	0.0
Grand_Duke_Konstantin_Nikolayevich_of_Russia	wikicat_Russian_grand_dukes	8	8	0	0.0
Mauritania	wordnet_country_108544813	1	1	0	0.0
Lusaka	wordnet_administrative_district_108491826	1	1	0	0.0
Robert_Silverberg	wikicat_American_science_fiction_writers	1	1	0	0.0
Order_of_the_Bath	wordnet_order_107168623	1	1	0	0.0
Mario_Bolatti	wikicat_Living_people	1	1	0	0.0
Raúl_(footballer)	wikicat_La_Liga_footballers	1	1	0	0.0
Kalusha_Bwalya	wikicat_Living_people	1	1	0	0.0
Daisuke_Matsui	wikicat_Bulgarian_A_Professional_Football_Group_players	2	2	0	0.0
Sylvia_Plath	wordnet_writer_110794014	1	1	0	0.0
Juventus_F.C.	wikicat_Football_clubs_in_Italy	1	1	0	0.0
S.E.F._Torres_1903	wikicat_Football_clubs_in_Italy	1	1	0	0.0
Washington,_D.C.	wikicat_Populated_places_on_the_Potomac_River	1	1	0	0.0
Fábio_Lima	wikicat_Living_people	1	1	0	0.0
Pakistan_Muslim_League_(N)	wikicat_Conservative_parties_in_Pakistan	1	1	0	0.0
Barnsley_F.C.	wikicat_Football_League_Championship_clubs	1	1	0	0.0
Frank_Arnesen	wikicat_Expatriate_footballers_in_Spain	1	1	0	0.0
Lev_Landau	wikicat_20th-century_physicists	1	1	0	0.0
Lisa_De_Vanna	wikicat_Living_people	1	1	0	0.0
Dário_Monteiro	wikicat_Living_people	1	1	0	0.0
Hugh_Grant	wikicat_20th-century_English_male_actors	2	2	0	0.0
Papua_New_Guinea	wikicat_English-speaking_countries_and_territories	1	1	0	0.0
Arthur_Moses	wikicat_Living_people	1	1	0	0.0
Richard_Conte	wikicat_Actors	1	1	0	0.0
Saint-Cloud	wikicat_Cities_in_France	1	1	0	0.0
Inter_Milan	wikicat_Italian_football_First_Division_clubs	2	2	0	0.0
Dominique_de_Villepin	wikicat_École_nationale_d'administration_alumni	2	2	0	0.0
The_Specials	wikicat_Reggae_musical_groups	1	1	0	0.0
Edmund_Gwenn	wikicat_20th-century_English_male_actors	1	1	0	0.0
Sisak-Moslavina_County	wikicat_Counties_of_Croatia	1	1	0	0.0
Michael_Thwaite	wikicat_Australian_soccer_players	1	1	0	0.0
Vital_Lyadzyanyow	wikicat_Living_people	1	1	0	0.0
Merkendorf,_Bavaria	wordnet_location_100027167	3	3	0	0.0
Clube_Atlético_Linense	wikicat_Football_clubs_in_São_Paulo_(state)	1	1	0	0.0
Togo	wikicat_Member_states_of_the_Organisation_of_Islamic_Cooperation	1	1	0	0.0
Ted_Hughes	wordnet_writer_110794014	1	1	0	0.0
Bakhtiyor_Ashurmatov	wikicat_Expatriate_footballers_in_Russia	1	1	0	0.0
Paulo_Figueiredo	wikicat_Segunda_Liga_players	3	3	0	0.0
Glasgow	wikicat_Lieutenancy_areas_of_Scotland	1	1	0	0.0
Philip_Roth	wikicat_Writers	1	1	0	0.0
Liza_Minnelli	wikicat_20th-century_American_actresses	1	1	0	0.0
Rijeka	wordnet_administrative_district_108491826	6	6	0	0.0
Joe_(singer)	wordnet_artist_109812338	1	1	0	0.0
Lijiang_Sanyi_Airport	wordnet_airport_102692232	1	1	0	0.0
Steve_Collis	wikicat_The_Football_League_players	1	1	0	0.0
Porto	wikicat_Municipalities_of_Portugal	1	1	0	0.0
Lon_Chaney,_Jr.	wikicat_20th-century_American_male_actors	1	1	0	0.0
Ironton,_Ohio	wikicat_County_seats_in_Ohio	1	1	0	0.0
Social_Democratic_Party_(Portugal)	wikicat_Liberal_parties	1	1	0	0.0
Democratic_Party_(United_States)	wordnet_party_108256968	1	1	0	0.0
George_Berkeley	wordnet_philosopher_110423589	1	1	0	0.0
Federico_Fellini	wordnet_person_100007846	1	1	0	0.0
Carnegie_Mellon_University	wikicat_Oak_Ridge_Associated_Universities	1	1	0	0.0
Daniel_Craig	wikicat_British_film_actors	1	1	0	0.0
FC_Botoșani	wikicat_Football_clubs_in_Romania	1	1	0	0.0
University_of_Paris-Sud	wordnet_university_108286569	1	1	0	0.0
Agnes_Moorehead	wikicat_American_actors	1	1	0	0.0
Paul_Wright_(footballer)	wikicat_Scottish_footballers	1	1	0	0.0
F.K._Partizan	wikicat_Association_football_clubs_established_in_1945	5	5	0	0.0
Cristiano_Ávalos	wikicat_Expatriate_footballers_in_South_Korea	1	1	0	0.0
Knoxville,_Tennessee	wikicat_Cities_in_Tennessee	1	1	0	0.0
Leonardo_André_Pimenta_Faria	wikicat_Living_people	1	1	0	0.0
Hull_City_A.F.C.	wikicat_Premier_League_clubs	1	1	0	0.0
Francis_Ford_Coppola	wikicat_Screenwriters	1	1	0	0.0
Marc_Arnold	wikicat_Bundesliga_players	1	1	0	0.0
Lisbon	wordnet_administrative_district_108491826	1	1	0	0.0
Andrés_Orozco	wikicat_Living_people	1	1	0	0.0
Liv_Tyler	wikicat_Actors_from_New_York_City	3	3	0	0.0
Yuriy_Moroz	wikicat_Living_people	1	1	0	0.0
Pascal_Zuberbühler	wikicat_Fulham_F.C._players	2	2	0	0.0
Mediterranean_Sea	wikicat_European_seas	5	5	0	0.0
War_of_the_Austrian_Succession	wikicat_Wars_involving_Russia	1	1	0	0.0
Mel_Tormé	wikicat_Telarc_Records_artists	27	27	0	0.0
Ernst_Mach	wordnet_scientist_110560637	1	1	0	0.0
Vietnam	wikicat_Socialist_states	1	1	0	0.0
Ricardo_Sousa	wikicat_Portuguese_footballers	1	1	0	0.0
Anel_Canales	wikicat_Association_football_forwards	1	1	0	0.0
Ihor_Zhabchenko	wikicat_Living_people	1	1	0	0.0
Gary_Alexander_(basketball)	wikicat_Living_people	1	1	0	0.0
Warsaw_West_County	wikicat_Land_counties_of_Masovian_Voivodeship	8	8	0	0.0
Republic_of_the_Congo	wikicat_French-speaking_countries_and_territories	1	1	0	0.0
Córdoba,_Argentina	wikicat_Capitals_of_Argentine_provinces	1	1	0	0.0
Rick_Astley	wikicat_British_musicians	1	1	0	0.0
Staples_Center	wordnet_stadium_104295881	1	1	0	0.0
Ambika_(actress)	wikicat_Indian_film_actresses	1	1	0	0.0
Kevin_Bacon	wikicat_American_film_directors	1	1	0	0.0
Carmarthen	wikicat_Populated_places_in_Wales	1	1	0	0.0
Krunoslav_Lovrek	wikicat_Süper_Lig_players	1	1	0	0.0
Marrakesh-Tensift-El_Haouz	wikicat_Subdivisions_of_Morocco	1	1	0	0.0
Mary_Astor	wikicat_American_film_actresses	1	1	0	0.0
Bastia	wikicat_Port_cities	1	1	0	0.0
Hungary	wikicat_Countries_in_Europe	1	1	0	0.0
Bihar	wikicat_States_and_territories_of_India	1	1	0	0.0
Socialist_Federal_Republic_of_Yugoslavia	wordnet_country_108544813	1	1	0	0.0
Benin	wikicat_Countries	1	1	0	0.0
Elmore_Leonard	wikicat_Writers	1	1	0	0.0
Edgar_Çani	wikicat_Serie_A_footballers	1	1	0	0.0
Danny_Higginbotham	wikicat_Living_people	1	1	0	0.0
Zacatepec	wikicat_Ascenso_MX_teams	1	1	0	0.0
Laurent_Fabius	wikicat_French_people	1	1	0	0.0
North_Korea	wordnet_country_108544813	1	1	0	0.0
Israel	wikicat_Countries	1	1	0	0.0
Portland,_Oregon	wikicat_Cities_in_Oregon	1	1	0	0.0
Málaga_C.F.	wordnet_club_108227214	1	1	0	0.0
Ricky_Gervais	wikicat_20th-century_actors	3	3	0	0.0
Christopher_Reeve	wikicat_Actors	1	1	0	0.0
Lyon	wordnet_commune_108541609	1	1	0	0.0
Charles_Darwin	wikicat_British_people	1	1	0	0.0
Joyce_Carol_Oates	wikicat_American_essayists	1	1	0	0.0
Edmund_Gwenn	wikicat_English_stage_actors	1	1	0	0.0
Kevin_Bacon	wikicat_American_actors	1	1	0	0.0
Union_Douala	wikicat_Football_clubs_in_Cameroon	1	1	0	0.0
Kylie_Minogue	wikicat_Australian_singers	1	1	0	0.0
Fluminense_F.C.	wikicat_Association_football_clubs_established_in_1902	1	1	0	0.0
Arabic_language	wordnet_language_106282651	1	1	0	0.0
Steve_Bowey	wikicat_Living_people	1	1	0	0.0
Federico_Fellini	wikicat_People_from_Rimini	1	1	0	0.0
Palm_Springs,_California	wikicat_Incorporated_cities_and_towns_in_California	1	1	0	0.0
Jonathan_Lethem	wikicat_Postmodern_writers	1	1	0	0.0
Jimmy_Carter	wordnet_officeholder_110371450	1	1	0	0.0
Antonio_Rizzolo	wikicat_Italian_footballers	1	1	0	0.0
Toronto	wordnet_administrative_district_108491826	1	1	0	0.0
Rhode_Island	wikicat_States_of_the_United_States	1	1	0	0.0
Dario_Smoje	wikicat_Serie_A_footballers	1	1	0	0.0
Nicolás_Muñoz	wikicat_People_from_Panama_City	3	3	0	0.0
William_Thomson,_1st_Baron_Kelvin	wikicat_People_associated_with_electricity	3	3	0	0.0
Rwanda	wikicat_Least_developed_countries	1	1	0	0.0
Eastbourne	wikicat_Non-metropolitan_districts	1	1	0	0.0
Steven_Spielberg	wikicat_American_film_directors	1	1	0	0.0
Sergey_Timofeev	wikicat_Living_people	1	1	0	0.0
Vesa-Matti_Loiri	wordnet_person_100007846	1	1	0	0.0
Uladzimir_Karytska	wikicat_Russian_Premier_League_players	1	1	0	0.0
Midge_Ure	wikicat_Living_people	1	1	0	0.0
Emerson_College	wikicat_Private_universities_and_colleges_in_the_United_States	1	1	0	0.0
University_of_Zurich	wordnet_university_108286569	1	1	0	0.0
Benton_County,_Minnesota	wikicat_Minnesota_counties	1	1	0	0.0
Courteney_Cox	wikicat_20th-century_American_actresses	1	1	0	0.0
Ilian_Iliev	wikicat_Expatriate_footballers_in_Portugal	2	2	0	0.0
Madeleine_Stowe	wikicat_American_television_actresses	1	1	0	0.0
FC_Khimki	wordnet_club_108227214	1	1	0	0.0
Split,_Croatia	wikicat_Populated_coastal_places_in_Croatia	1	1	0	0.0
Galați	wikicat_Towns	1	1	0	0.0
Azerbaijan	wikicat_Landlocked_countries	3	3	0	0.0
Ahmed_Deen	wikicat_Living_people	1	1	0	0.0
Ricardo_Rocha_(Portuguese_footballer)	wikicat_Expatriate_footballers_in_Belgium	1	1	0	0.0
Roger_Penrose	wikicat_20th-century_physicists	2	2	0	0.0
C.D._Numancia_de_Soria	wikicat_Football_clubs_in_Castile_and_León	1	1	0	0.0
Drago_Jančar	wikicat_Prešeren_laureates	1	1	0	0.0
Bolivia	wikicat_Countries	1	1	0	0.0
Mauritania	wikicat_West_African_countries	1	1	0	0.0
Immanuel_Kant	wikicat_Ethnic_German_people	1	1	0	0.0
Vannevar_Bush	wordnet_scientist_110560637	1	1	0	0.0
Mark_Crossley	wikicat_Living_people	1	1	0	0.0
Danilo_Sacramento	wikicat_Brazilian_footballers	1	1	0	0.0
Genoa_C.F.C.	wikicat_Lega_Pro_Prima_Divisione_clubs	1	1	0	0.0
University_of_Portland	wikicat_Roman_Catholic_universities_and_colleges	1	1	0	0.0
Riccardo_Nardini	wikicat_Reggina_Calcio_players	3	3	0	0.0
Torquay_United_F.C.	wikicat_Southern_Football_League_clubs	1	1	0	0.0
Charles_Akonnor	wikicat_Ghana_international_footballers	1	1	0	0.0
Albert_Lea,_Minnesota	wikicat_County_seats_in_Minnesota	2	2	0	0.0
Hermann_Hreiðarsson	wikicat_Iceland_international_footballers	1	1	0	0.0
Jonathan_Walters	wikicat_Premier_League_players	1	1	0	0.0
1._FSV_Mainz_05	wikicat_Football_clubs_in_Rhineland-Palatinate	1	1	0	0.0
Neustrelitz	wikicat_Towns_in_Mecklenburg-Vorpommern	1	1	0	0.0
Norman_Foster_(director)	wikicat_American_male_film_actors	2	2	0	0.0
Reinaldo_da_Cruz_Oliveira	wikicat_Expatriate_footballers_in_South_Korea	1	1	0	0.0
Albert_Einstein	wikicat_Nobel_laureates_in_Physics	2	2	0	0.0
Bozhidar_Iskrenov	wikicat_PFC_Levski_Sofia_players	3	3	0	0.0
Steve_Hackett	wikicat_Rock_guitarists	5	5	0	0.0
Shahid_Kapoor	wikicat_Indian_actors	1	1	0	0.0
Tony_Sealy	wikicat_The_Football_League_players	1	1	0	0.0
Manuel_Almunia	wikicat_Segunda_División_B_footballers	1	1	0	0.0
W._S._Van_Dyke	wikicat_American_people	1	1	0	0.0
Elmore_Leonard	wikicat_American_writers	1	1	0	0.0
Luke_Corbett	wikicat_Living_people	1	1	0	0.0
Eduardo_Carvalho	wikicat_Primeira_Liga_players	1	1	0	0.0
Recklinghausen	wikicat_Towns_in_North_Rhine-Westphalia	1	1	0	0.0
Cameron_Mitchell_(actor)	wikicat_20th-century_American_male_actors	1	1	0	0.0
Edward_Witten	wikicat_20th-century_physicists	1	1	0	0.0
Turkey_national_under-21_football_team	wordnet_football_team_108080025	1	1	0	0.0
Republic_of_Ireland	wikicat_Member_states_of_the_United_Nations	1	1	0	0.0
Cyril_Jeunechamp	wikicat_Ligue_2_players	1	1	0	0.0
Gena_Rowlands	wordnet_person_100007846	1	1	0	0.0
Bruce_Dickinson	wikicat_English-language_singers	2	2	0	0.0
Mounir_El_Hamdaoui	wikicat_La_Liga_footballers	2	2	0	0.0
A.C._Monza_Brianza_1912	wikicat_Serie_B_clubs	1	1	0	0.0
Grzegorz_Sandomierski	wikicat_Polish_expatriate_footballers	1	1	0	0.0
Opoczno_County	wikicat_Land_counties_of_Łódź_Voivodeship	1	1	0	0.0
Afghanistan	wikicat_Countries	1	1	0	0.0
Mounir_El_Hamdaoui	wikicat_Dutch_expatriates_in_England	2	2	0	0.0
Michał_Kalecki	wikicat_20th-century_economists	1	1	0	0.0
Kalusha_Bwalya	wikicat_Belgian_Pro_League_players	1	1	0	0.0
Rafael_Carlos_Santacruz	wikicat_Valencia_CF_Mestalla_footballers	2	2	0	0.0
Silviu_Izvoranu	wikicat_Living_people	1	1	0	0.0
Sisak-Moslavina_County	wordnet_administrative_district_108491826	1	1	0	0.0
Barry_Wong	wikicat_Hong_Kong_screenwriters	4	4	0	0.0
Iberian_Peninsula	wikicat_Peninsulas_of_Europe	5	5	0	0.0
K.S.V._Waregem	wikicat_Football_clubs_in_Belgium	1	1	0	0.0
Hichem_Mezaïr	wikicat_USM_Alger_players	6	6	0	0.0
Clinton_County,_Ohio	wikicat_Populated_places_established_in_1810	1	1	0	0.0
La_Cañada_Flintridge,_California	wikicat_Incorporated_cities_and_towns_in_California	1	1	0	0.0
Adam_Smith	wikicat_Academics_of_the_University_of_Glasgow	1	1	0	0.0
Port-au-Prince	wikicat_Port_cities_in_the_Caribbean	1	1	0	0.0
Daniel_Dennett	wikicat_American_people	1	1	0	0.0
Hanover	wordnet_location_100027167	1	1	0	0.0
Delron_Buckley	wikicat_VfL_Bochum_players	11	11	0	0.0
French_language	wikicat_Languages_of_Europe	1	1	0	0.0
Pescara	wikicat_Cities_and_towns_in_Italy	1	1	0	0.0
Dennis_Virkler	wikicat_American_Cinema_Editors	1	1	0	0.0
David_Seaman	wikicat_English_footballers	1	1	0	0.0
Andrzej_Bledzewski	wikicat_Living_people	1	1	0	0.0
Jay_Mohr	wikicat_Actors	1	1	0	0.0
Université_libre_de_Bruxelles	wordnet_university_108286569	1	1	0	0.0
Shirley_Jones	wikicat_American_television_actresses	1	1	0	0.0
Kuwait	wordnet_country_108544813	1	1	0	0.0
Union_for_a_Popular_Movement	wordnet_party_108256968	1	1	0	0.0
University_at_Buffalo,_The_State_University_of_New_York	wordnet_university_108286569	1	1	0	0.0
Greenock_Morton_F.C.	wikicat_Football_clubs_in_Scotland	1	1	0	0.0
Gustavo_Reggi	wikicat_Argentine_expatriate_footballers	1	1	0	0.0
S.S.D._Piacenza_Calcio_1919	wikicat_Lega_Pro_Seconda_Divisione_clubs	1	1	0	0.0
Michael_Hughes_(footballer)	wikicat_Ligue_1_players	1	1	0	0.0
Lindsay_Lohan	wikicat_Women	1	1	0	0.0
North_African_Campaign	wikicat_Battles_of_World_War_II_involving_Germany	8	8	0	0.0
Elie_Aiboy	wikicat_2004_AFC_Asian_Cup_players	1	1	0	0.0
Red_Bull_Brasil	wikicat_Football_clubs_in_São_Paulo_(city)	1	1	0	0.0
Madeleine_Stowe	wikicat_American_film_actresses	1	1	0	0.0
North_East_England	wikicat_NUTS_1_statistical_regions_of_the_European_Union	1	1	0	0.0
Győr	wikicat_County_seats_in_Hungary	1	1	0	0.0
Pat_Morita	wikicat_20th-century_American_male_actors	1	1	0	0.0
Alex_Revell	wikicat_English_footballers	1	1	0	0.0
Torino_F.C.	wikicat_Serie_A_clubs	1	1	0	0.0
Sextus_Empiricus	wikicat_Historians_of_philosophy	18	18	0	0.0
Stephen_Wright_(English_footballer)	wikicat_English_footballers	1	1	0	0.0
South_Africa	wikicat_Member_states_of_the_African_Union	1	1	0	0.0
Maurice_Ross	wikicat_Süper_Lig_players	1	1	0	0.0
Suat_Usta	wikicat_Turkish_footballers	1	1	0	0.0
Delta_Goodrem	wikicat_Australian_female_singers	14	14	0	0.0
José_Martí_International_Airport	wikicat_Airfields_of_the_United_States_Army_Air_Forces	1	1	0	0.0
Kiki_Musampa	wikicat_Dutch_footballers	3	3	0	0.0
Géza_Kalocsay	wikicat_AC_Sparta_Prague_players	2	2	0	0.0
Crawford_County,_Kansas	wordnet_county_108546183	1	1	0	0.0
Ion_Vélez	wikicat_Segunda_División_B_footballers	1	1	0	0.0
Zambia	wikicat_Countries_in_Africa	1	1	0	0.0
Naples_International_Airport	wikicat_Airports_in_Europe	2	2	0	0.0
Ludwig_Maximilian_University_of_Munich	wikicat_Public_universities	2	2	0	0.0
Ayman_Abdelaziz	wikicat_Süper_Lig_players	1	1	0	0.0
Paulette_Goddard	wordnet_person_100007846	1	1	0	0.0
Royal_Thai_Navy_F.C.	wordnet_club_108227214	1	1	0	0.0
Turkey	wikicat_Middle_Eastern_countries	2	2	0	0.0
Gabri_García	wikicat_FC_Barcelona_B_footballers	1	1	0	0.0
Marin_Petrov	wikicat_Bulgarian_A_Professional_Football_Group_players	1	1	0	0.0
Nicolae_Dică	wikicat_Living_people	1	1	0	0.0
Hugh_Grant	wikicat_Actors	1	1	0	0.0
George_Abbott	wikicat_American_male_stage_actors	28	28	0	0.0
F.C._Südtirol	wikicat_Football_clubs_in_Italy	1	1	0	0.0
Steven_Spielberg	wikicat_American_people	1	1	0	0.0
Jason_Blunt	wikicat_Living_people	1	1	0	0.0
Richard_Feynman	wikicat_American_physicists	1	1	0	0.0
Delta_Goodrem	wikicat_Australian_television_actors	1	1	0	0.0
Vanuatu	wikicat_Island_countries	2	2	0	0.0
Jari_Litmanen	wikicat_Eredivisie_players	1	1	0	0.0
Jun_Senoue	wordnet_artist_109812338	1	1	0	0.0
Maggie_Gyllenhaal	wikicat_21st-century_American_actresses	1	1	0	0.0
Paniliakos_F.C.	wikicat_Football_clubs_in_Greece	1	1	0	0.0
Patrick_Dimbala	wikicat_Living_people	1	1	0	0.0
Nikola_Karčev	wikicat_Living_people	1	1	0	0.0
Soviet_Union	wordnet_country_108544813	1	1	0	0.0
Dario_Smoje	wikicat_Superleague_Greece_players	1	1	0	0.0
Carl_Airey	wikicat_The_Football_League_players	1	1	0	0.0
Toufik_Zerara	wikicat_Algerian_Ligue_Professionnelle_1_players	3	3	0	0.0
Rochester,_Minnesota	wikicat_County_seats_in_Minnesota	2	2	0	0.0
Phil_Keaggy	wikicat_American_male_singers	4	4	0	0.0
Bridge_Boys_F.C.	wikicat_Sports_clubs_in_Nigeria	1	1	0	0.0
Abia_State	wikicat_States_in_Igboland	1	1	0	0.0
Teenage_Mutant_Ninja_Turtles_(film_series)	wikicat_Films_featuring_anthropomorphic_characters	4	4	0	0.0
Turek_County	wikicat_Land_counties_of_Greater_Poland_Voivodeship	1	1	0	0.0
Jack_Cork	wikicat_England_under-21_international_footballers	1	1	0	0.0
Union_for_French_Democracy	wikicat_Political_parties_in_France	1	1	0	0.0
Ronald_Colman	wikicat_English_actors	1	1	0	0.0
Dune_(film)	wikicat_American_films	1	1	0	0.0
Belgium	wikicat_French-speaking_countries_and_territories	1	1	0	0.0
Kamehameha_I	wordnet_sovereign_110628644	1	1	0	0.0
The_Story_of_Alexander_Graham_Bell	wikicat_English-language_films	1	1	0	0.0
Warsaw	wordnet_administrative_district_108491826	1	1	0	0.0
Moldova	wikicat_Member_states_of_the_United_Nations	1	1	0	0.0
Jürgen_Moser	wikicat_Mathematical_analysts	1	1	0	0.0
Nancy_Sinatra	wikicat_Living_people	1	1	0	0.0
Atherton,_California	wikicat_Cities_in_San_Mateo_County,_California	2	2	0	0.0
Bournemouth	wordnet_site_108651247	1	1	0	0.0
Andrey_Movsisyan	wikicat_Russian_Premier_League_players	1	1	0	0.0
Castile-La_Mancha	wikicat_NUTS_2_statistical_regions_of_the_European_Union	1	1	0	0.0
Edvard_Kocbek	wikicat_Slovenian_translators	1	1	0	0.0
Bulgaria	wikicat_Member_states_of_the_Union_for_the_Mediterranean	1	1	0	0.0
Charlotte_Eagles	wikicat_A-League_(1995–2004)_teams	1	1	0	0.0
Oak_Lawn,_Illinois	wikicat_Villages_in_Illinois	1	1	0	0.0
A.C._Prato	wikicat_Lega_Pro_Prima_Divisione_clubs	2	2	0	0.0
Eric_Idle	wikicat_English_male_film_actors	1	1	0	0.0
Waupaca_County,_Wisconsin	wordnet_county_108546183	1	1	0	0.0
Georges_Bataille	wikicat_French_philosophers	1	1	0	0.0
Gina_Lollobrigida	wikicat_Women	1	1	0	0.0
Julia_Kristeva	wikicat_Women	1	1	0	0.0
Paul_Bastock	wikicat_English_footballers	1	1	0	0.0
Slovenia	wikicat_Countries	1	1	0	0.0
Frank_Skinner_(composer)	wikicat_American_composers	1	1	0	0.0
Club_Olimpia	wordnet_club_108227214	1	1	0	0.0
Jusuf_Dajić	wikicat_Expatriate_footballers_in_Germany	1	1	0	0.0
Marion_Zimmer_Bradley	wikicat_Writers	1	1	0	0.0
Sullivan_County,_Missouri	wikicat_Missouri_counties	1	1	0	0.0
Turku	wikicat_Cities_and_towns_in_Finland	1	1	0	0.0
Syangja_District	wikicat_Districts_of_Nepal	1	1	0	0.0
Romy_Schneider	wikicat_Women	1	1	0	0.0
Fathi_Chebal	wikicat_Ligue_2_players	2	2	0	0.0
Thespakusatsu_Gunma	wikicat_Football_clubs_in_Japan	1	1	0	0.0
Hristo_Stoichkov	wikicat_Bulgarian_expatriates_in_Spain	1	1	0	0.0
Bristol_Rovers_F.C.	wikicat_Football_clubs_in_England	1	1	0	0.0
Cuca_(footballer)	wikicat_Brazil_international_footballers	11	11	0	0.0
Modena_F.C.	wikicat_Italian_football_First_Division_clubs	1	1	0	0.0
Don_DeLillo	wikicat_American_writers	1	1	0	0.0
Damián_Manso	wikicat_Ligue_1_players	1	1	0	0.0
Forman_Christian_College	wikicat_Universities_and_colleges_in_Pakistan	1	1	0	0.0
Frederik_Pohl	wikicat_English-language_writers	3	3	0	0.0
Gena_Rowlands	wikicat_American_actors	1	1	0	0.0
Harvey_Keitel	wikicat_People_from_New_York_City	1	1	0	0.0
Carlos_Squeo	wikicat_Racing_Club_de_Avellaneda_footballers	10	10	0	0.0
FC_Levadia_Tallinn	wordnet_club_108227214	1	1	0	0.0
Italian_Socialist_Party	wikicat_Political_parties_disestablished_in_1994	1	1	0	0.0
James_Hetfield	wikicat_Musicians_from_California	3	3	0	0.0
Northern_Illinois_University	wikicat_State_universities_in_Illinois	1	1	0	0.0
La_Marsa	wikicat_Communes_of_Tunisia	2	2	0	0.0
Santos_FC_(women)	wordnet_club_108227214	1	1	0	0.0
Oumar_Dieng	wikicat_Living_people	1	1	0	0.0
Mato_Neretljak	wikicat_Living_people	1	1	0	0.0
Edmund_Gwenn	wikicat_English_male_stage_actors	2	2	0	0.0
Albania	wordnet_country_108544813	1	1	0	0.0
Patricia_Neal	wikicat_American_actresses	1	1	0	0.0
Kazakhstan	wordnet_country_108544813	1	1	0	0.0
KAC_Marrakech	wordnet_club_108227214	1	1	0	0.0
Joan_Capdevila	wikicat_UEFA_Euro_2004_players	59	59	0	0.0
Bernard_Hill	wikicat_English_stage_actors	1	1	0	0.0
Birmingham_City_F.C.	wikicat_Premier_League_clubs	1	1	0	0.0
Portugal	wikicat_Countries_in_Europe	1	1	0	0.0
Graziano_Pellè	wikicat_Eredivisie_players	1	1	0	0.0
New_Delhi	wikicat_Planned_cities	1	1	0	0.0
Brendan_Fraser	wikicat_American_male_film_actors	1	1	0	0.0
Haifa	wikicat_Port_cities_in_Israel	1	1	0	0.0
Bangladesh	wikicat_Countries	1	1	0	0.0
Buenos_Aires	wikicat_Port_settlements_in_Argentina	1	1	0	0.0
Republic_of_the_Congo	wikicat_Countries_in_Africa	1	1	0	0.0
Frankfurt	wikicat_Cities_in_Germany	1	1	0	0.0
Vincent_Sasso	wikicat_Expatriate_footballers_in_Portugal	1	1	0	0.0
Daniel_McBreen	wikicat_The_Football_League_players	1	1	0	0.0
Orlando_International_Airport	wordnet_airport_102692232	1	1	0	0.0
Havnar_Bóltfelag	wordnet_club_108227214	1	1	0	0.0
Alice_Munro	wikicat_Postmodern_writers	1	1	0	0.0
Blois	wikicat_Cities_in_France	1	1	0	0.0
Steve_Jones_(Northern_Irish_footballer)	wikicat_Football_Conference_players	2	2	0	0.0
London_School_of_Economics	wordnet_university_108286569	1	1	0	0.0
Cameroon	wikicat_Countries_in_Africa	1	1	0	0.0
Sarah_Jessica_Parker	wikicat_American_film_actresses	1	1	0	0.0
Bronze_Star_Medal	wikicat_Awards_and_decorations_of_the_United_States_Coast_Guard	1	1	0	0.0
FK_Željezničar_Sarajevo	wordnet_club_108227214	1	1	0	0.0
Italy_national_under-21_football_team	wordnet_football_team_108080025	1	1	0	0.0
Dennis_Virkler	wikicat_Living_people	1	1	0	0.0
Dera_Ismail_Khan_District	wordnet_administrative_district_108491826	1	1	0	0.0
Wet_Hot_American_Summer	wikicat_English-language_films	1	1	0	0.0
John_Fraser_(footballer_born_1876)	wikicat_Newcastle_United_F.C._players	261	261	0	0.0
Adam_Rooney	wikicat_Scottish_Premier_League_players	1	1	0	0.0
Mia_Farrow	wikicat_American_film_actresses	1	1	0	0.0
Czechoslovak_government-in-exile	wikicat_States_and_territories_established_in_1939	1	1	0	0.0
Kallithea_F.C.	wordnet_club_108227214	1	1	0	0.0
Lisbon_Region	wikicat_Regions_of_Portugal	1	1	0	0.0
Greg_Bear	wikicat_Writers	1	1	0	0.0
Bruno_Šundov	wikicat_Living_people	1	1	0	0.0
Tottenham_Hotspur_F.C.	wikicat_Premier_League_clubs	2	2	0	0.0
Agnes_Moorehead	wikicat_American_film_actresses	1	1	0	0.0
Tuscany	wikicat_Wine_regions_of_Italy	1	1	0	0.0
Paulette_Goddard	wikicat_Actors	1	1	0	0.0
University_of_Wisconsin–Madison	wordnet_university_108286569	1	1	0	0.0
North_America	wikicat_Continents	1	1	0	0.0
Pernik	wordnet_administrative_district_108491826	1	1	0	0.0
Uppsala_County	wikicat_Counties_of_Sweden	1	1	0	0.0
Foeke_Booy	wikicat_Living_people	1	1	0	0.0
Pendle	wikicat_Non-metropolitan_districts	1	1	0	0.0
Rouen	wikicat_Cities_in_France	1	1	0	0.0
Texas	wikicat_States_of_the_Confederate_States_of_America	1	1	0	0.0
Max_Planck	wikicat_Ethnic_German_people	1	1	0	0.0
Jan_Budtz	wikicat_Living_people	1	1	0	0.0
York_City_F.C.	wikicat_Football_clubs_in_England	1	1	0	0.0
Tony_Curtis	wordnet_person_100007846	1	1	0	0.0
Hussein_of_Jordan	wordnet_sovereign_110628644	1	1	0	0.0
Wallace_Shawn	wikicat_21st-century_American_writers	35	35	0	0.0
Gilda_Radner	wikicat_American_stage_actresses	4	4	0	0.0
Lisbon	wikicat_Populated_coastal_places_in_Portugal	1	1	0	0.0
Anthony_Réveillère	wikicat_Ligue_1_players	1	1	0	0.0
Togo	wikicat_French-speaking_countries_and_territories	1	1	0	0.0
Smith_College	wikicat_Private_universities_and_colleges_in_the_United_States	1	1	0	0.0
Nick_Ward_(Australian_footballer)	wikicat_Living_people	1	1	0	0.0
Sam_Gargan	wikicat_The_Football_League_players	1	1	0	0.0
Odessa	wikicat_Populated_coastal_places_in_Ukraine	1	1	0	0.0
Daniel_Arismendi	wikicat_Living_people	1	1	0	0.0
Beijing	wordnet_administrative_district_108491826	1	1	0	0.0
Hans_Bethe	wikicat_American_physicists	1	1	0	0.0
Bristol_Rovers_F.C.	wikicat_Southern_Football_League_clubs	1	1	0	0.0
Eastbourne	wikicat_Towns_in_East_Sussex	1	1	0	0.0
Debbie_Reynolds	wikicat_20th-century_actresses	3	3	0	0.0
Andy_King_(footballer,_born_1956)	wikicat_English_footballers	1	1	0	0.0
Andy_Williams_(Jamaican_footballer)	wikicat_Living_people	1	1	0	0.0
Rory_May	wikicat_Solihull_Borough_F.C._players	2	2	0	0.0
Lithuania	wikicat_Member_states_of_NATO	1	1	0	0.0
Charlie_Chaplin	wikicat_People_from_London	2	2	0	0.0
Salem,_Ohio	wikicat_Cities_in_Ohio	1	1	0	0.0
Neustrelitz	wikicat_Municipalities_in_Mecklenburg-Vorpommern	1	1	0	0.0
Marc_Arnold	wikicat_Living_people	1	1	0	0.0
Harvey_Keitel	wikicat_21st-century_actors	2	2	0	0.0
John_McAliskey	wikicat_Living_people	1	1	0	0.0
Turkmenistan	wordnet_country_108544813	1	1	0	0.0
Maria_Bello	wikicat_Living_people	1	1	0	0.0
Rally_of_the_French_People	wordnet_party_108256968	1	1	0	0.0
Charleston_(South_Carolina)	wordnet_administrative_district_108491826	1	1	0	0.0
Robert_Silverberg	wikicat_21st-century_American_novelists	1	1	0	0.0
Stuart_Fleetwood	wikicat_Living_people	1	1	0	0.0
Warren_Cummings	wikicat_The_Football_League_players	1	1	0	0.0
Roger_Glover	wordnet_artist_109812338	1	1	0	0.0
Šiauliai	wikicat_Cities_in_Lithuania	1	1	0	0.0
Volta_Redonda	wikicat_Cities_in_Brazil	1	1	0	0.0
Borujen_County	wikicat_Counties_of_Chaharmahal_and_Bakhtiari_Province	1	1	0	0.0
Loja_Province	wordnet_administrative_district_108491826	1	1	0	0.0
Montedio_Yamagata	wikicat_J._League_clubs	1	1	0	0.0
Charles_de_Gaulle	wikicat_Knights_of_the_Elephant	1	1	0	0.0
Prizren	wikicat_Municipalities_of_Kosovo	1	1	0	0.0
Sékou_Tidiane_Souaré	wikicat_People_from_Abidjan	1	1	0	0.0
Eduardo_Costa	wikicat_Brazilian_expatriate_footballers	1	1	0	0.0
London_School_of_Economics	wikicat_Universities_in_England	1	1	0	0.0
Saša_Ćurčić	wikicat_Expatriate_footballers_in_Scotland	5	5	0	0.0
Branco_(footballer)	wikicat_Expatriate_soccer_players_in_the_United_States	1	1	0	0.0
Watford	wikicat_Villages_in_Hertfordshire	1	1	0	0.0
Riccardo_Nardini	wikicat_Italian_footballers	1	1	0	0.0
Subrahmanyan_Chandrasekhar	wikicat_20th-century_physicists	1	1	0	0.0
Ceuta	wordnet_administrative_district_108491826	1	1	0	0.0
Nicolae_Dică	wikicat_FC_CFR_Cluj_players	6	6	0	0.0
Finland	wikicat_Member_states_of_the_Council_of_Europe	3	3	0	0.0
Democratic_Republic_of_the_Congo	wikicat_Central_African_countries	1	1	0	0.0
Finland_national_football_team	wikicat_European_national_association_football_teams	3	3	0	0.0
Bob_Hope	wordnet_person_100007846	1	1	0	0.0
Humboldt_University_of_Berlin	wordnet_university_108286569	1	1	0	0.0
Matteo_Contini	wikicat_Serie_B_footballers	1	1	0	0.0
Namur	wordnet_municipality_108626283	2	2	0	0.0
Marc_Anthony	wordnet_artist_109812338	1	1	0	0.0
University_of_Southern_California	wordnet_university_108286569	1	1	0	0.0
FC_Hoverla_Uzhhorod	wordnet_club_108227214	1	1	0	0.0
Graziano_Pellè	wikicat_Living_people	1	1	0	0.0
Yalta	wikicat_Cities_in_Crimea	3	3	0	0.0
Rod_Serling	wikicat_American_people	1	1	0	0.0
Eduardo_Costa	wikicat_Campeonato_Brasileiro_Série_A_footballers	1	1	0	0.0
Johnny_Torres	wikicat_American_soccer_players	2	2	0	0.0
Mecklenburg-Vorpommern	wikicat_NUTS_1_statistical_regions_of_the_European_Union	2	2	0	0.0
Charles_S._Dutton	wikicat_American_actors	1	1	0	0.0
Stefano_Borgonovo	wikicat_Italian_footballers	2	2	0	0.0
Barnsley_F.C.	wikicat_Football_clubs_in_England	1	1	0	0.0
Rudolf_Peierls	wikicat_20th-century_physicists	1	1	0	0.0
André_3000	wikicat_American_male_film_actors	5	5	0	0.0
Dakota_Wizards	wikicat_Basketball_clubs_established_in_1995	1	1	0	0.0
Alberta	wikicat_Canadian_Prairies	2	2	0	0.0
Alexander_Haig	wikicat_American_politicians	1	1	0	0.0
Gifu_(prefecture)	wikicat_Subdivisions_of_Japan	1	1	0	0.0
Quentin_Tarantino	wikicat_21st-century_American_male_actors	1	1	0	0.0
Cameroon	wikicat_Member_states_of_La_Francophonie	1	1	0	0.0
Zimbabwe	wikicat_Countries_in_Africa	1	1	0	0.0
Bruno_Akrapović	wikicat_Bundesliga_players	1	1	0	0.0
Zoran_Zeljković	wikicat_Slovenian_footballers	1	1	0	0.0
Madeleine_Stowe	wikicat_American_people	1	1	0	0.0
Aleksandar_Komadina	wikicat_Living_people	1	1	0	0.0
Uzbekistan	wikicat_States_and_territories_established_in_1991	1	1	0	0.0
Birmingham,_Michigan	wikicat_Populated_places_established_in_1819	1	1	0	0.0
Rafael_Carlos_Santacruz	wikicat_Living_people	1	1	0	0.0
Philadelphia	wordnet_administrative_district_108491826	1	1	0	0.0
Ecuador	wordnet_country_108544813	1	1	0	0.0
Sandro_Calabro	wikicat_Living_people	1	1	0	0.0
Bydgoszcz	wikicat_Cities_and_towns_in_Kuyavian-Pomeranian_Voivodeship	1	1	0	0.0
Arnhem	wikicat_Populated_places_in_Gelderland	1	1	0	0.0
Sheffield_Wednesday_F.C.	wikicat_Football_clubs_in_England	1	1	0	0.0
Buckethead	wikicat_Rock_guitarists	10	10	0	0.0
Steve_Jones_(Northern_Irish_footballer)	wikicat_Northern_Ireland_international_footballers	2	2	0	0.0
Lionel_Jospin	wikicat_Sciences_Po_alumni	1	1	0	0.0
Valentino_Lai	wikicat_Swedish_expatriate_footballers	2	2	0	0.0
Anel_Canales	wikicat_Panamanian_footballers	1	1	0	0.0
Lagos	wikicat_Populated_coastal_places_in_Nigeria	2	2	0	0.0
Dili	wikicat_Capitals	2	2	0	0.0
Émile_Mpenza	wikicat_Belgian_Pro_League_players	1	1	0	0.0
Tallahassee,_Florida	wikicat_Cities_in_Florida	1	1	0	0.0
Ryan_Jarvis	wikicat_Association_football_forwards	1	1	0	0.0
Winston_Churchill	wordnet_officeholder_110371450	1	1	0	0.0
R.C.D._Espanyol_de_Barcelona	wordnet_club_108227214	2	2	0	0.0
Djibouti	wikicat_Member_states_of_the_Arab_League	1	1	0	0.0
T._S._Eliot	wikicat_English-language_writers	1	1	0	0.0
Christian_Callejas	wikicat_Uruguayan_footballers	1	1	0	0.0
Clint_Eastwood	wikicat_20th-century_American_actors	1	1	0	0.0
Danny_Califf	wikicat_Danish_Superliga_players	2	2	0	0.0
Luciano_de_Souza	wikicat_Expatriate_footballers_in_Greece	1	1	0	0.0
Pepe_Reina	wikicat_Living_people	1	1	0	0.0
Columbia_Business_School	wikicat_Universities_and_colleges_in_New_York_City	2	2	0	0.0
Reinaldo_da_Cruz_Oliveira	wikicat_K_League_players	1	1	0	0.0
Henry_Fonda	wordnet_person_100007846	1	1	0	0.0
Spain	wordnet_country_108544813	1	1	0	0.0
Dorge_Kouemaha	wikicat_Cameroon_international_footballers	1	1	0	0.0
Fabio_Bazzani	wikicat_Serie_A_footballers	1	1	0	0.0
Brian_O'Nolan	wikicat_Irish_novelists	2	2	0	0.0
Warren_Cummings	wikicat_Association_football_defenders	1	1	0	0.0
Arkansas	wikicat_States_of_the_Confederate_States_of_America	1	1	0	0.0
Enköping_Municipality	wikicat_Municipalities_of_Sweden	1	1	0	0.0
Iceland	wikicat_Germanic_countries_and_territories	3	3	0	0.0
John_Milton	wikicat_Writers	1	1	0	0.0
Maurizio_Gaudino	wikicat_German_expatriate_footballers	1	1	0	0.0
Upton_Sinclair	wikicat_Writers	1	1	0	0.0
Haim_Silvas	wikicat_Living_people	1	1	0	0.0
Mark_Prudhoe	wikicat_Bristol_City_F.C._players	1	1	0	0.0
Bridgend	wikicat_Cities_in_Wales	1	1	0	0.0
The_Bronx	wordnet_administrative_district_108491826	1	1	0	0.0
Roberto_Trashorras	wikicat_Real_Madrid_C.F._players	16	16	0	0.0
Pete_Seeger	wordnet_artist_109812338	1	1	0	0.0
Clackmannanshire	wikicat_Council_areas_of_Scotland	1	1	0	0.0
Slidell,_Louisiana	wikicat_Cities_in_St._Tammany_Parish,_Louisiana	1	1	0	0.0
St._Mirren_F.C.	wikicat_Scottish_Professional_Football_League_teams	1	1	0	0.0
Freiburg	wikicat_Cities_in_Baden-Württemberg	1	1	0	0.0
Denmark	wikicat_Member_states_of_the_Union_for_the_Mediterranean	1	1	0	0.0
Somalia	wikicat_Member_states_of_the_United_Nations	1	1	0	0.0
Hapoel_Rishon_LeZion_F.C.	wordnet_club_108227214	1	1	0	0.0
Avimiled_Rivas	wikicat_SD_Eibar_footballers	2473	2473	0	0.0
Steve_Croudson	wikicat_Football_Conference_players	1	1	0	0.0
Liam_Lawrence	wikicat_Expatriate_footballers_in_Greece	1	1	0	0.0
Uzbekistan	wikicat_Member_states_of_the_Organisation_of_Islamic_Cooperation	1	1	0	0.0
Georges_Pompidou	wikicat_École_Normale_Supérieure_alumni	1	1	0	0.0
Suat_Usta	wikicat_Living_people	1	1	0	0.0
Wallace_Shawn	wordnet_person_100007846	1	1	0	0.0
Townsville	wordnet_site_108651247	1	1	0	0.0
VU_University_Amsterdam	wordnet_university_108286569	2	2	0	0.0
Richard_Conte	wikicat_American_male_film_actors	1	1	0	0.0
Sani_Kaita	wikicat_Living_people	1	1	0	0.0
John_Huston	wikicat_American_people_of_English_descent	1	1	0	0.0
Australia_national_football_team	wikicat_Asian_national_association_football_teams	3	3	0	0.0
VfL_Osnabrück	wikicat_Football_clubs_in_Germany	1	1	0	0.0
Henry_Adams	wikicat_Writers	1	1	0	0.0
Košice_Region	wikicat_Regions_of_Slovakia	1	1	0	0.0
Gerry_Britton	wikicat_Scottish_Football_League_players	1	1	0	0.0
Namibia	wikicat_African_countries	1	1	0	0.0
Ecole_Spéciale_Militaire_de_Saint-Cyr	wikicat_Educational_institutions_established_in_1802	1	1	0	0.0
Alexander_Herzen	wikicat_Russian_agnostics	2	2	0	0.0
Trabzon	wikicat_Ancient_Greek_sites_in_Turkey	1	1	0	0.0
Richard_Duffy	wikicat_Living_people	1	1	0	0.0
Óscar_Díaz_González	wikicat_Spanish_footballers	1	1	0	0.0
Olubayo_Adefemi	wikicat_Nigerian_people	4	4	0	0.0
Terence_Winter	wordnet_person_100007846	1	1	0	0.0
Pakistan	wikicat_South_Asian_countries	1	1	0	0.0
Bănel_Nicoliță	wikicat_Living_people	1	1	0	0.0
Seïd_Khiter	wikicat_Living_people	1	1	0	0.0
Western_New_York_Flash	wikicat_Association_football_clubs_established_in_2008	1	1	0	0.0
Thompson,_Connecticut	wikicat_Cities_in_Connecticut	1	1	0	0.0
Reading,_Massachusetts	wikicat_Towns_in_Massachusetts	1	1	0	0.0
Chemnitzer_FC	wikicat_Association_football_clubs_established_in_1920	1	1	0	0.0
Holger_Fach	wikicat_Living_people	1	1	0	0.0
Burundi	wordnet_country_108544813	1	1	0	0.0
Richmond_Kickers	wikicat_Soccer_clubs_in_the_United_States	1	1	0	0.0
Carrie_Fisher	wikicat_20th-century_actresses	1	1	0	0.0
Mauritius	wikicat_Countries_in_Africa	1	1	0	0.0
Mamadou_Bagayoko	wikicat_AC_Ajaccio_players	10	10	0	0.0
Nikola_Lazetić	wikicat_Serbian_expatriate_footballers	2	2	0	0.0
Fürth	wikicat_Cities_in_Germany	1	1	0	0.0
Janakpur_Zone	wikicat_Zones_of_Nepal	2	2	0	0.0
Macedonia_national_football_team	wordnet_football_team_108080025	1	1	0	0.0
Sanchez_Watt	wikicat_English_footballers	1	1	0	0.0
Osamu_Tezuka	wikicat_Japanese_screenwriters	2	2	0	0.0
Mirko_Plantić	wikicat_Living_people	1	1	0	0.0
FC_Argeș_Pitești	wikicat_Defunct_football_clubs_in_Romania	1	1	0	0.0
Hans_Bethe	wikicat_Nuclear_physicists	5	5	0	0.0
Gary_Barlow	wikicat_20th-century_British_people	89	89	0	0.0
Moscow	wikicat_Hero_Cities_of_the_Soviet_Union	1	1	0	0.0
Faizabad	wordnet_administrative_district_108491826	1	1	0	0.0
FC_Argeș_Pitești	wordnet_club_108227214	1	1	0	0.0
Brooke_Shields	wikicat_People_from_New_York_City	1	1	0	0.0
Julianne_Moore	wikicat_American_actresses	1	1	0	0.0
Lev_Landau	wikicat_Lenin_Prize_winners	18	18	0	0.0
Landshut	wordnet_location_100027167	2	2	0	0.0
Guinea-Bissau	wikicat_African_countries	1	1	0	0.0
Rik_Mayall	wikicat_Actors	1	1	0	0.0
New_York_City	wordnet_administrative_district_108491826	1	1	0	0.0
Oumar_Kondé	wikicat_2._Bundesliga_players	1	1	0	0.0
Jeffrey_Jones	wikicat_American_actors	1	1	0	0.0
Alfred_Hörtnagl	wikicat_Expatriate_footballers_in_Greece	2	2	0	0.0
FC_Hlučín	wikicat_Football_clubs_in_the_Czech_Republic	2	2	0	0.0
Matthew_Bellamy	wikicat_British_guitarists	1	1	0	0.0
Ankaraspor_A.Ş.	wikicat_Association_football_clubs_established_in_1978	1	1	0	0.0
Maastricht	wikicat_Cities_in_the_Netherlands	1	1	0	0.0
Paul_Konchesky	wikicat_West_Ham_United_F.C._players	1	1	0	0.0
Jairo_Castillo	wikicat_Primera_División_Argentina_players	1	1	0	0.0
Brooke_Shields	wikicat_20th-century_actors	1	1	0	0.0
Indiana_Pacers	wikicat_Basketball_teams_in_the_United_States	1	1	0	0.0
Stichtse_Vecht	wikicat_Municipalities_of_Utrecht_(province)	1	1	0	0.0
Efan_Ekoku	wikicat_The_Football_League_players	1	1	0	0.0
Émile_Durkheim	wikicat_French_people	1	1	0	0.0
The_Simpsons_Movie	wikicat_American_animated_films	1	1	0	0.0
Simran_(actress)	wikicat_20th-century_Indian_actresses	1	1	0	0.0
Albion_Rovers_F.C.	wikicat_Scottish_Football_League_teams	1	1	0	0.0
SV_Eintracht_Trier_05	wikicat_Football_clubs_in_Germany	1	1	0	0.0
Stephen_King	wikicat_American_people	1	1	0	0.0
Sheffield	wordnet_site_108651247	1	1	0	0.0
Alexandre_Faioli	wikicat_Living_people	1	1	0	0.0
Darío_Flores	wikicat_Liga_I_players	1	1	0	0.0
Eduardo_Costa	wikicat_AS_Monaco_FC_players	1	1	0	0.0
George_Abbott	wikicat_Male_actors_from_New_York_City	125	125	0	0.0
Joe_Bradshaw_(footballer)	wikicat_Fulham_F.C._players	4	4	0	0.0
C.F._Os_Belenenses	wikicat_Multi-sport_clubs_in_Portugal	2	2	0	0.0
Calcio_Padova	wordnet_club_108227214	1	1	0	0.0
Udinese_Calcio	wikicat_Italian_football_First_Division_clubs	2	2	0	0.0
Mérida,_Mérida	wordnet_administrative_district_108491826	1	1	0	0.0
Slovenia	wordnet_country_108544813	1	1	0	0.0
Cristiano_Ávalos	wikicat_Brazilian_expatriate_footballers	1	1	0	0.0
Vijay_(actor)	wikicat_20th-century_Indian_male_actors	4	4	0	0.0
Roberto_Merino	wikicat_RCD_Mallorca_footballers	3	3	0	0.0
Molot-Prikamye_Perm	wordnet_team_108208560	1	1	0	0.0
Tunisia	wikicat_Countries_in_Africa	1	1	0	0.0
Long_Beach,_California	wikicat_Incorporated_cities_and_towns_in_California	1	1	0	0.0
Raja_Gosnell	wikicat_Living_people	1	1	0	0.0
Vyacheslav_Sviderskyi	wikicat_FC_Dnipro_Dnipropetrovsk_players	1	1	0	0.0
Riza_Lushta	wikicat_Serie_A_footballers	2	2	0	0.0
Rafael_Carlos_Santacruz	wikicat_Spanish_footballers	1	1	0	0.0
West_Hollywood,_California	wikicat_Former_census-designated_places_in_California	3	3	0	0.0
C.S._Marítimo	wikicat_Multi-sport_clubs_in_Portugal	1	1	0	0.0
Murat_Ocak	wikicat_Süper_Lig_players	1	1	0	0.0
Courteney_Cox	wikicat_American_television_actresses	1	1	0	0.0
Freiburg	wordnet_location_100027167	1	1	0	0.0
Kristian_Flittie_Onstad	wikicat_Norwegian_expatriate_footballers	4	4	0	0.0
Kenya	wikicat_Member_states_of_the_Commonwealth_of_Nations	1	1	0	0.0
ND_Gorica	wikicat_Football_clubs_in_Yugoslavia	1	1	0	0.0
Linz	wikicat_Populated_places_on_the_Danube	1	1	0	0.0
Rose_McGowan	wikicat_Actors	1	1	0	0.0
San_Jose_Earthquakes_(1974–88)	wikicat_Defunct_indoor_soccer_clubs_in_the_United_States	1	1	0	0.0
William_James	wikicat_People_from_New_York_City	1	1	0	0.0
Tallinn	wikicat_Capitals_in_Europe	1	1	0	0.0
Pepe_Reina	wikicat_Tercera_División_footballers	3	3	0	0.0
Álvaro_del_Moral	wikicat_Madrilenian_footballers	2	2	0	0.0
Colin_Firth	wikicat_20th-century_actors	1	1	0	0.0
K._Balachander	wikicat_Hindi-language_film_directors	1	1	0	0.0
Patrick_White	wikicat_Writers	1	1	0	0.0
Singapore	wikicat_Chinese-speaking_countries_and_territories	7	7	0	0.0
Samuel_R._Delany	wikicat_Science_fiction_writers	1	1	0	0.0
Patricia_Neal	wikicat_Women	1	1	0	0.0
Roberto_Trashorras	wikicat_La_Liga_footballers	1	1	0	0.0
Lugano_District	wikicat_Districts_of_Ticino	1	1	0	0.0
Seol_Ki-hyeon	wikicat_K_League_players	2	2	0	0.0
Ayman_Abdelaziz	wikicat_Living_people	1	1	0	0.0
Konrad_Adenauer	wordnet_officeholder_110371450	1	1	0	0.0
Rot_Weiss_Ahlen	wikicat_Football_clubs_in_Germany	1	1	0	0.0
Bruno_Akrapović	wikicat_2._Bundesliga_players	1	1	0	0.0
Stefan_Majewski	wikicat_Widzew_Łódź_managers	1	1	0	0.0
Sergei_Kolotovkin	wikicat_FC_Tyumen_players	2	2	0	0.0
Fabiano_Pereira	wikicat_Expatriate_footballers_in_Spain	2	2	0	0.0
Szombathely	wikicat_Cities_in_Hungary	1	1	0	0.0
Tunisia	wikicat_French-speaking_countries_and_territories	1	1	0	0.0
Gilda_Radner	wikicat_20th-century_American_actresses	1	1	0	0.0
Belarus	wikicat_Countries	1	1	0	0.0
Liam_Lawrence	wikicat_English_footballers	1	1	0	0.0
K._Balachander	wikicat_Indian_screenwriters	1	1	0	0.0
Lääne_County	wordnet_country_108544813	1	1	0	0.0
Rhineland-Palatinate	wordnet_administrative_district_108491826	3	3	0	0.0
Jean_Harlow	wordnet_person_100007846	1	1	0	0.0
Bashiru_Gambo	wikicat_2._Bundesliga_players	1	1	0	0.0
Alain_Delon	wikicat_French_people	1	1	0	0.0
Sarah_Jessica_Parker	wikicat_Women	1	1	0	0.0
Yaroslav_Svorak	wikicat_FC_Karpaty_Lviv_players	3	3	0	0.0
Argentina	wikicat_Countries	1	1	0	0.0
Veenendaal	wordnet_administrative_district_108491826	1	1	0	0.0
Tunisia	wikicat_Member_states_of_the_African_Union	1	1	0	0.0
Fort_Walton_Beach,_Florida	wikicat_Cities_in_Florida	1	1	0	0.0
Carl_Airey	wikicat_English_footballers	1	1	0	0.0
Wiener_Sport-Club	wikicat_Football_clubs_in_Austria	1	1	0	0.0
Esporte_Clube_São_Bento	wikicat_Association_football_clubs_established_in_1913	1	1	0	0.0
King's_College_London	wikicat_Universities_in_England	1	1	0	0.0
Kingdom_of_Württemberg	wikicat_States_of_the_German_Empire	2	2	0	0.0
Mali	wikicat_West_African_countries	1	1	0	0.0
Palermo	wordnet_administrative_district_108491826	1	1	0	0.0
Ronald_Reagan	wikicat_20th-century_American_male_actors	2	2	0	0.0
Montreal	wikicat_Port_settlements_in_Quebec	1	1	0	0.0
Genoa_C.F.C.	wikicat_Serie_B_clubs	1	1	0	0.0
Fritz_Lang	wikicat_Western_(genre)_film_directors	1	1	0	0.0
Spain	wikicat_Member_states_of_the_European_Union	1	1	0	0.0
Mahesh_Babu	wikicat_Indian_actors	1	1	0	0.0
Ukraine	wikicat_Countries	1	1	0	0.0
June_Allyson	wordnet_person_100007846	1	1	0	0.0
John_Cassavetes	wikicat_American_film_directors	1	1	0	0.0
Lumberton,_North_Carolina	wikicat_Cities_in_North_Carolina	1	1	0	0.0
Alain_Juppé	wikicat_French_people	1	1	0	0.0
Koblenz	wordnet_location_100027167	1	1	0	0.0
Chile	wikicat_Member_states_of_the_Union_of_South_American_Nations	1	1	0	0.0
Fritz_Fuchs	wikicat_Bundesliga_players	1	1	0	0.0
Maggie_Gyllenhaal	wikicat_21st-century_actors	6	6	0	0.0
Hollywood_Party_(1934_film)	wikicat_American_comedy_films	1	1	0	0.0
Gabon	wikicat_Member_states_of_the_African_Union	1	1	0	0.0
Montreal	wikicat_Populated_places_established_in_1642	1	1	0	0.0
Prešov_Region	wikicat_NUTS_3_statistical_regions_of_the_European_Union	1	1	0	0.0
Tennis_Borussia_Berlin	wordnet_club_108227214	1	1	0	0.0
Dennis_Miller	wikicat_Living_people	1	1	0	0.0
Manchester_United_F.C.	wikicat_Football_clubs_in_England	2	2	0	0.0
C.F._Monterrey	wikicat_Football_clubs_in_Monterrey	5	5	0	0.0
The_Last_Judgement_(1961_film)	wikicat_1960s_comedy_films	5	5	0	0.0
Søren_Larsen	wikicat_Bundesliga_players	1	1	0	0.0
FC_Zürich	wikicat_Football_clubs_in_Switzerland	1	1	0	0.0
Henri_Lefebvre	wordnet_philosopher_110423589	2	2	0	0.0
Tommy_Tynan	wikicat_The_Football_League_players	1	1	0	0.0
Ever_Cantero	wikicat_Paraguayan_footballers	2	2	0	0.0
Carrie_Fisher	wikicat_American_stage_actresses	1	1	0	0.0
Sydney_Olympic_FC	wikicat_Soccer_clubs_in_Sydney	2	2	0	0.0
Ian_Thomas-Moore	wikicat_The_Football_League_players	1	1	0	0.0
Angela_Bassett	wikicat_American_television_actors	1	1	0	0.0
Krunoslav_Lovrek	wikicat_Belgian_Pro_League_players	1	1	0	0.0
Russian_Empire	wikicat_Empires	1	1	0	0.0
Worms	wikicat_Former_countries_in_Europe	1	1	0	0.0
A.C.R._Messina	wikicat_Football_clubs_in_Italy	1	1	0	0.0
Robert_Rodriguez	wikicat_American_film_directors	1	1	0	0.0
Mia_Farrow	wikicat_Actors	1	1	0	0.0
Tabriz	wikicat_World_Heritage_Sites_in_Iran	3	3	0	0.0
Daphne_du_Maurier	wikicat_British_people	1	1	0	0.0
FC_Politehnica_Iași	wordnet_club_108227214	1	1	0	0.0
Club_Atlético_Vélez_Sarsfield	wordnet_club_108227214	4	4	0	0.0
Sendai	wikicat_Populated_coastal_places_in_Japan	1	1	0	0.0
Mamoru_Oshii	wikicat_Anime_directors	1	1	0	0.0
Stefano_Borgonovo	wikicat_Serie_B_footballers	2	2	0	0.0
John_Grisham	wikicat_American_people	1	1	0	0.0
Livingston_F.C.	wikicat_Scottish_Football_League_teams	1	1	0	0.0
Bruno_Alves	wikicat_Russian_Premier_League_players	2	2	0	0.0
Tunisia	wikicat_Member_states_of_the_Union_for_the_Mediterranean	2	2	0	0.0
Albert_Camus	wikicat_French_journalists	16	16	0	0.0
Kingdom_of_Württemberg	wikicat_States_of_the_Confederation_of_the_Rhine	2	2	0	0.0
William_Holden	wikicat_American_male_film_actors	1	1	0	0.0
Charlotte_Gainsbourg	wikicat_Living_people	2	2	0	0.0
Radosław_Kałużny	wikicat_Bundesliga_players	1	1	0	0.0
Battle_of_Leipzig	wikicat_Battles_involving_Germany	2	2	0	0.0
Meryl_Streep	wikicat_American_actresses	1	1	0	0.0
Piła	wikicat_Cities_and_towns_in_Greater_Poland_Voivodeship	1	1	0	0.0
Janakpur_Zone	wordnet_zone_108688247	2	2	0	0.0
U.S._Cremonese	wikicat_Lega_Pro_Seconda_Divisione_clubs	1	1	0	0.0
Highland_Park,_Michigan	wikicat_Cities_in_Michigan	1	1	0	0.0
Chester_City_F.C.	wikicat_Defunct_Football_League_clubs	3	3	0	0.0
Sweden	wordnet_country_108544813	1	1	0	0.0
Nikola_Karčev	wikicat_Macedonian_footballers	1	1	0	0.0
Terrel_Castle	wikicat_American_expatriate_basketball_people_in_Israel	14	14	0	0.0
John_Swihart	wikicat_Living_people	1	1	0	0.0
Henderson,_Nevada	wikicat_Cities_in_Clark_County,_Nevada	4	4	0	0.0
University_of_Wisconsin–Madison	wikicat_Land-grant_universities_and_colleges	1	1	0	0.0
Jordan	wikicat_Middle_Eastern_countries	1	1	0	0.0
Blauw-Wit_Amsterdam	wordnet_club_108227214	1	1	0	0.0
Julio_Cortázar	wikicat_Writers	1	1	0	0.0
Émerson_Leão	wikicat_Sociedade_Esportiva_Palmeiras_players	2	2	0	0.0
União_São_João_Esporte_Clube	wikicat_Association_football_clubs_established_in_1981	1	1	0	0.0
Luís_Eduardo_Schmidt	wikicat_La_Liga_footballers	1	1	0	0.0
Édison_Méndez	wikicat_Irapuato_FC_footballers	3	3	0	0.0
Diego_Tristán	wikicat_Expatriate_footballers_in_Italy	3	3	0	0.0
Deportivo_de_La_Coruña	wikicat_Organisations_based_in_Spain_with_royal_patronage	1	1	0	0.0
Erik_Edman	wikicat_Sweden_international_footballers	2	2	0	0.0
Junior_F.C.	wikicat_Categoría_Primera_A_clubs	1	1	0	0.0
Shooting_Stars_SC	wikicat_Sports_clubs_in_Nigeria	1	1	0	0.0
Comoros	wikicat_Swahili-speaking_countries_and_territories	2	2	0	0.0
1._FC_Slovácko	wikicat_Football_clubs_in_the_Czech_Republic	1	1	0	0.0
Berekum_Arsenal	wikicat_Sports_clubs_in_Ghana	1	1	0	0.0
Michal_Kubala	wikicat_Living_people	1	1	0	0.0
Santo_Tirso_Municipality	wikicat_Cities_in_Portugal	1	1	0	0.0
Kashima_Antlers	wikicat_Japan_Soccer_League_clubs	1	1	0	0.0
Paul_Bastock	wikicat_Living_people	1	1	0	0.0
U.S._Lecce	wikicat_Serie_B_clubs	1	1	0	0.0
David_García_Haro	wikicat_Segunda_División_B_footballers	1	1	0	0.0
Zagreb	wikicat_Subdivisions_of_Croatia	1	1	0	0.0
Frank_Sinatra	wikicat_American_singers	2	2	0	0.0
Nijkerk	wordnet_administrative_district_108491826	1	1	0	0.0
Winnipeg_Jets	wordnet_team_108208560	1	1	0	0.0
Angola	wikicat_Member_states_of_the_African_Union	1	1	0	0.0
Clint_Eastwood	wikicat_Western_(genre)_film_actors	1	1	0	0.0
Ilian_Iliev	wikicat_Expatriate_footballers_in_Greece	1	1	0	0.0
Stendhal	wordnet_writer_110794014	1	1	0	0.0
Giulio_Andreotti	wikicat_Prime_Ministers_of_Italy	1	1	0	0.0
Hugh_Grant	wikicat_English_television_actors	2	2	0	0.0
Llandudno	wikicat_Populated_places_in_Wales	1	1	0	0.0
Christian_Brand	wikicat_Bundesliga_players	1	1	0	0.0
Victoria_Cougars_(WHL)	wordnet_team_108208560	2	2	0	0.0
Club_Atlético_Banfield	wikicat_Argentine_field_hockey_clubs	1	1	0	0.0
Vatican_City	wikicat_Countries_in_Europe	2	2	0	0.0
Jade_North	wikicat_Australia_international_soccer_players	1	1	0	0.0
Mala_Sinha	wikicat_Indian_film_actresses	1	1	0	0.0
Bolivia_national_football_team	wordnet_football_team_108080025	1	1	0	0.0
Marcos_Alonso_Peña	wikicat_La_Liga_footballers	2	2	0	0.0
Boston_Breakers	wikicat_Women's_association_football_clubs	1	1	0	0.0
Werner_Heisenberg	wikicat_Ethnic_German_people	1	1	0	0.0
Lincoln	wikicat_County_towns_in_England	5	5	0	0.0
Burgas_Province	wordnet_state_108654360	1	1	0	0.0
NK_Bravo1_Interblock	wordnet_club_108227214	1	1	0	0.0
Geoffrey_Castillion	wikicat_Living_people	1	1	0	0.0
Gene_Kelly	wikicat_American_actors	1	1	0	0.0
Assam	wordnet_administrative_district_108491826	1	1	0	0.0
S.L._Benfica	wikicat_Multi-sport_clubs_in_Portugal	1	1	0	0.0
Henri_Fuchs	wikicat_German_footballers	1	1	0	0.0
James_Ivory_(director)	wikicat_American_film_directors	1	1	0	0.0
Heidelberg	wikicat_Cities_in_Germany	1	1	0	0.0
Chennai	wikicat_Populated_coastal_places_in_India	1	1	0	0.0
Fernando_Sales	wikicat_La_Liga_footballers	2	2	0	0.0
Brian_Martin_(footballer)	wikicat_Scottish_footballers	1	1	0	0.0
Hetman_Zamość	wikicat_Association_football_clubs_established_in_1934	1	1	0	0.0
David_Cox_(statistician)	wordnet_scientist_110560637	1	1	0	0.0
Sétif	wikicat_Communes_of_Algeria	1	1	0	0.0
War_of_the_Sixth_Coalition	wordnet_conflict_100958896	1	1	0	0.0
Radomir_Đalović	wikicat_Red_Star_Belgrade_footballers	4	4	0	0.0
Bath,_Maine	wordnet_administrative_district_108491826	1	1	0	0.0
Greece	wikicat_Member_states_of_the_Union_for_the_Mediterranean	1	1	0	0.0
Inverell	wikicat_Towns_in_New_South_Wales	1	1	0	0.0
Samir_Aliyev	wikicat_Living_people	1	1	0	0.0
Clube_Atlético_Mineiro	wikicat_Football_clubs_in_Minas_Gerais	1	1	0	0.0
Tallahassee,_Florida	wordnet_administrative_district_108491826	1	1	0	0.0
Habib_Bamogo	wikicat_People_from_Paris	1	1	0	0.0
Burt_Bacharach	wikicat_Living_people	1	1	0	0.0
Bruce_Greenwood	wikicat_Canadian_male_television_actors	1	1	0	0.0
Bayer_04_Leverkusen	wikicat_Unrelegated_association_football_clubs	11	11	0	0.0
Suriname	wikicat_Countries	1	1	0	0.0
Oleg_Veretennikov	wikicat_Living_people	1	1	0	0.0
Hamburger_SV_II	wordnet_club_108227214	1	1	0	0.0
New_Hampshire	wikicat_States_of_the_United_States	1	1	0	0.0
Gainsborough_Trinity_F.C.	wikicat_Northern_Premier_League_clubs	1	1	0	0.0
FC_Admira_Wacker_Mödling	wikicat_Football_clubs_in_Austria	1	1	0	0.0
Bolu	wikicat_Cities_in_Turkey	3	3	0	0.0
Sligo	wikicat_Towns_in_Ireland	1	1	0	0.0
André_Weil	wordnet_scientist_110560637	1	1	0	0.0
Gmina_Żukowo	wordnet_administrative_district_108491826	1	1	0	0.0
Hugo_Award	wikicat_Science_fiction_awards	1	1	0	0.0
Paulus_Roiha	wikicat_Finnish_expatriate_footballers	2	2	0	0.0
John_Cassavetes	wikicat_20th-century_American_male_actors	1	1	0	0.0
Annaba	wikicat_Communes_of_Algeria	1	1	0	0.0
Stephan_Kling	wikicat_2._Bundesliga_players	1	1	0	0.0
Aníbal_Cavaco_Silva	wikicat_Living_people	1	1	0	0.0
Joe_Cocker	wikicat_British_composers	9	9	0	0.0
Versailles	wikicat_Prefectures_in_France	1	1	0	0.0
Damascus	wordnet_site_108651247	1	1	0	0.0
Battle_of_Britain_(film)	wordnet_movie_106613686	1	1	0	0.0
Chulalongkorn	wordnet_sovereign_110628644	1	1	0	0.0
Alicia_Silverstone	wikicat_American_television_actresses	1	1	0	0.0
David_Arquette	wikicat_Actors	1	1	0	0.0
Ivan_Dragičević	wikicat_Living_people	1	1	0	0.0
Porto_Alegre	wikicat_Populated_places_in_Rio_Grande_do_Sul	1	1	0	0.0
Tiago_Bernardini	wikicat_People_from_Araras	1	1	0	0.0
Atlético_Madrid_B	wikicat_Football_clubs_in_Spain	1	1	0	0.0
Scarborough,_Ontario	wikicat_Former_municipalities_in_Toronto	1	1	0	0.0
Chloë_Sevigny	wikicat_American_television_actors	1	1	0	0.0
Wassily_Leontief	wikicat_American_economists	1	1	0	0.0
Perth	wikicat_Towns_in_Western_Australia	1	1	0	0.0
Valencia_BC	wikicat_Liga_ACB_teams	1	1	0	0.0
Marcos_Denner	wikicat_Expatriate_footballers_in_South_Korea	1	1	0	0.0
Philip_Pullman	wikicat_British_children's_writers	3	3	0	0.0
Sandra_Bullock	wikicat_21st-century_actors	1	1	0	0.0
Frosinone_Calcio	wikicat_Lega_Pro_Prima_Divisione_clubs	1	1	0	0.0
Amanda_Lear	wikicat_Living_people	1	1	0	0.0
France	wikicat_Member_states_of_the_United_Nations	1	1	0	0.0
Rimas_Kurtinaitis	wikicat_Expatriate_basketball_people_in_Australia	1	1	0	0.0
Air_Medal	wikicat_Military_awards_and_decorations_of_the_United_States	1	1	0	0.0
Alastair_Reynolds	wordnet_writer_110794014	1	1	0	0.0
F.C._Porto	wikicat_Superleague_Formula_clubs	1	1	0	0.0
Zonguldak	wordnet_administrative_district_108491826	1	1	0	0.0
Chakhir_Belghazouani	wikicat_Expatriate_footballers_in_Switzerland	1	1	0	0.0
Angela_Bassett	wikicat_American_actresses	1	1	0	0.0
Russia_national_under-21_football_team	wordnet_football_team_108080025	1	1	0	0.0
Pau,_France	wordnet_commune_108541609	1	1	0	0.0
Serge_Gainsbourg	wikicat_People_from_Paris	1	1	0	0.0
Iraq	wikicat_Member_states_of_the_Organisation_of_Islamic_Cooperation	1	1	0	0.0
Cambodia	wikicat_Countries	1	1	0	0.0
Real_Betis	wikicat_La_Liga_clubs	1	1	0	0.0
Don_Droege	wikicat_Major_Indoor_Soccer_League_(1978–92)_players	1	1	0	0.0
Botafogo_F.R.	wordnet_club_108227214	2	2	0	0.0
Stockholm	wikicat_Port_cities_and_towns_of_the_Baltic_Sea	1	1	0	0.0
Ruth_Rendell	wikicat_British_people	1	1	0	0.0
Ricardo_Villar_(Brazilian_footballer)	wikicat_Brazilian_footballers	1	1	0	0.0
David_Arquette	wikicat_20th-century_actors	1	1	0	0.0
William_Golding	wikicat_British_Nobel_laureates	8	8	0	0.0
Rio_de_Janeiro	wikicat_Port_cities	1	1	0	0.0
Angola	wikicat_Bantu_countries_and_territories	1	1	0	0.0
San_Isidro,_Buenos_Aires	wordnet_administrative_district_108491826	1	1	0	0.0
Kevin_Bacon	wikicat_20th-century_actors	1	1	0	0.0
Rovigo_Calcio	wikicat_Lega_Pro_Seconda_Divisione_clubs	3	3	0	0.0
Mauricio_Hanuch	wikicat_Olimpo_footballers	1	1	0	0.0
Argentinos_Juniors	wikicat_Argentine_field_hockey_clubs	1	1	0	0.0
FC_Felgueiras	wordnet_club_108227214	1	1	0	0.0
Bernardo_Romeo	wikicat_La_Liga_footballers	1	1	0	0.0
Dorge_Kouemaha	wikicat_Bundesliga_players	1	1	0	0.0
Havlíčkův_Brod_District	wordnet_administrative_district_108491826	1	1	0	0.0
Chiapas_F.C.	wordnet_club_108227214	1	1	0	0.0
Stephen_Dorff	wikicat_American_male_film_actors	1	1	0	0.0
Malaysia	wikicat_Member_states_of_the_Commonwealth_of_Nations	1	1	0	0.0
Nikola_Karčev	wikicat_Expatriate_footballers_in_Russia	1	1	0	0.0
Syria	wikicat_Middle_Eastern_countries	1	1	0	0.0
Iván_Guerrero	wikicat_Living_people	1	1	0	0.0
Togo	wikicat_African_countries	1	1	0	0.0
Simon_Donaldson	wordnet_scientist_110560637	1	1	0	0.0
Lucas_County,_Ohio	wordnet_county_108546183	5	5	0	0.0
Ely_Thadeu	wikicat_Brazilian_footballers	1	1	0	0.0
CA_Bordj_Bou_Arréridj	wikicat_Algerian_Ligue_Professionnelle_1_clubs	1	1	0	0.0
Obadiah_Tarumbwa	wikicat_Living_people	1	1	0	0.0
Peter_Fonda	wikicat_American_actors	1	1	0	0.0
Malaysia	wikicat_Member_states_of_the_Organisation_of_Islamic_Cooperation	1	1	0	0.0
Abdus_Salam	wikicat_20th-century_physicists	1	1	0	0.0
Paul_Wright_(footballer)	wikicat_Scottish_Football_League_players	1	1	0	0.0
Uzbekistan	wikicat_Countries	1	1	0	0.0
Robert_Fogel	wikicat_20th-century_economists	1	1	0	0.0
Mounir_Chaftar	wikicat_German_footballers	1	1	0	0.0
Mobile,_Alabama	wordnet_administrative_district_108491826	1	1	0	0.0
England_national_under-19_football_team	wordnet_football_team_108080025	1	1	0	0.0
Benin	wikicat_Countries_in_Africa	1	1	0	0.0
Cologne	wikicat_Municipalities_in_North_Rhine-Westphalia	1	1	0	0.0
University_of_Birmingham	wordnet_university_108286569	1	1	0	0.0
Abraham_Wald	wordnet_scientist_110560637	1	1	0	0.0
Joyce_Carol_Oates	wikicat_Women	1	1	0	0.0
Joanne_Dru	wikicat_American_television_actresses	2	2	0	0.0
Abraham_Lincoln	wikicat_American_lawyers	1	1	0	0.0
Prince_Philip,_Duke_of_Edinburgh	wikicat_Fellows_of_the_Royal_Society	1	1	0	0.0
Djibouti	wordnet_country_108544813	1	1	0	0.0
Enyimba_International_F.C.	wikicat_Sports_clubs_in_Nigeria	1	1	0	0.0
Peter_Debye	wikicat_20th-century_physicists	1	1	0	0.0
Charlie_Chaplin	wikicat_British_film_actors	2	2	0	0.0
McAlester,_Oklahoma	wikicat_Cities_in_Oklahoma	1	1	0	0.0
Kingdom_of_Prussia	wikicat_Former_countries_in_Europe	1	1	0	0.0
Shergo_Biran	wikicat_2._Bundesliga_players	1	1	0	0.0
Kevin_Bacon	wikicat_20th-century_American_male_actors	1	1	0	0.0
Order_of_Liberty	wikicat_Civil_awards_and_decorations	1	1	0	0.0
Amy_Adams	wikicat_Actors	1	1	0	0.0
Lev_Landau	wikicat_Russian_people	1	1	0	0.0
Anders_Jacobsen_(footballer)	wikicat_Living_people	1	1	0	0.0
Vatican_City	wordnet_country_108544813	2	2	0	0.0
Pat_Sharkey	wikicat_Living_people	1	1	0	0.0
Mario_Cáceres	wikicat_Living_people	1	1	0	0.0
Iran	wikicat_Countries	1	1	0	0.0
Bangalore	wordnet_administrative_district_108491826	1	1	0	0.0
Anne_Baxter	wordnet_person_100007846	1	1	0	0.0
Tanya_Tucker	wikicat_American_musicians	2	2	0	0.0
CFR_Cluj	wordnet_club_108227214	1	1	0	0.0
Tom_Stoppard	wikicat_British_dramatists_and_playwrights	2	2	0	0.0
S.P.A.L._2013	wikicat_Lega_Pro_Seconda_Divisione_clubs	1	1	0	0.0
J._R._Bremer	wikicat_Liga_ACB_players	1	1	0	0.0
Momo_(Spanish_footballer)	wikicat_La_Liga_footballers	1	1	0	0.0
Dario_Smoje	wikicat_Croatian_expatriate_footballers	1	1	0	0.0
Willard_Van_Orman_Quine	wordnet_philosopher_110423589	1	1	0	0.0
Pat_Morita	wikicat_American_people	1	1	0	0.0
Dario_Dabac	wikicat_Expatriate_footballers_in_China	1	1	0	0.0
Allan_Nielsen	wikicat_Danish_footballers	1	1	0	0.0
Pacific_War	wordnet_conflict_100958896	1	1	0	0.0
Petar_Krpan	wikicat_Croatian_footballers	1	1	0	0.0
Rwanda	wordnet_country_108544813	1	1	0	0.0
Leixões_S.C.	wikicat_Association_football_clubs_established_in_1907	4	4	0	0.0
Alan_Ladd	wordnet_person_100007846	1	1	0	0.0
Tennessee	wordnet_administrative_district_108491826	1	1	0	0.0
Stephen_Bywater	wikicat_Premier_League_players	1	1	0	0.0
Carrie_Fisher	wikicat_American_actresses	1	1	0	0.0
Debbie_Reynolds	wikicat_American_actresses	1	1	0	0.0
Julio_César_Uribe	wikicat_Peruvian_expatriate_footballers	1	1	0	0.0
Carl_Pentney	wikicat_English_footballers	1	1	0	0.0
Bănel_Nicoliță	wikicat_Romania_international_footballers	2	2	0	0.0
Kid_Rock	wikicat_American_hip_hop_singers	22	22	0	0.0
Jerry_Pournelle	wikicat_Living_people	2	2	0	0.0
José_Augusto_Freitas_Sousa	wikicat_Brazilian_expatriate_footballers	1	1	0	0.0
Wivenhoe_Town_F.C.	wordnet_club_108227214	1	1	0	0.0
Lyndon_B._Johnson	wikicat_American_people_of_British_descent	1	1	0	0.0
Ludwigshafen	wikicat_Cities_in_Germany	2	2	0	0.0
Robert_Jarni	wikicat_Expatriate_footballers_in_Italy	1	1	0	0.0
Claudette_Colbert	wikicat_American_actors	1	1	0	0.0
Danny_Graham_(footballer)	wikicat_Premier_League_players	1	1	0	0.0
Jim_Kerr_(footballer_born_1959)	wikicat_Falkirk_F.C._players	2	2	0	0.0
Valentino_Lai	wikicat_Danish_Superliga_players	2	2	0	0.0
East_Midlands	wikicat_Regions_of_England	1	1	0	0.0
Burundi	wikicat_Least_developed_countries	1	1	0	0.0
Leeds	wordnet_site_108651247	1	1	0	0.0
U.S._Città_di_Palermo	wikicat_Italian_football_First_Division_clubs	1	1	0	0.0
Duke_University	wikicat_Universities_and_colleges_accredited_by_the_Southern_Association_of_Colleges_and_Schools	1	1	0	0.0
Georgios_Vakouftsis	wikicat_Serie_A_footballers	2	2	0	0.0
Kjetil_Wæhler	wikicat_Allsvenskan_players	2	2	0	0.0
Davide_Marchini	wikicat_Italian_footballers	2	2	0	0.0
Timo_Ochs	wikicat_2._Bundesliga_players	1	1	0	0.0
Gustavo_Victoria	wikicat_Süper_Lig_players	1	1	0	0.0
The_Dirty_Dozen	wikicat_American_films	1	1	0	0.0
Province_of_Teruel	wikicat_Provinces_of_Spain	2	2	0	0.0
Świecie_County	wikicat_Counties_of_Poland	1	1	0	0.0
50_Cent	wikicat_American_actors	1	1	0	0.0
Kazakhstan	wikicat_Member_states_of_the_United_Nations	1	1	0	0.0
Cologne	wikicat_Cities_in_North_Rhine-Westphalia	1	1	0	0.0
Jean-Emmanuel_Effa_Owona	wikicat_Ligue_1_players	1	1	0	0.0
NK_Varaždin	wikicat_Football_clubs_in_Croatia	2	2	0	0.0
Murray_Gell-Mann	wikicat_American_agnostics	2	2	0	0.0
Charles_Akonnor	wikicat_Ghanaian_footballers	1	1	0	0.0
Barry_Manilow	wikicat_American_actors	1	1	0	0.0
Cape_Town	wikicat_Cities_in_South_Africa	1	1	0	0.0
Michigan_City,_Indiana	wordnet_administrative_district_108491826	2	2	0	0.0
Jair_Baylón	wikicat_Living_people	1	1	0	0.0
Emerson_College	wordnet_university_108286569	1	1	0	0.0
Kazakhstan_national_football_team	wikicat_Asian_national_association_football_teams	1	1	0	0.0
Fredrik_Björck	wikicat_Swedish_footballers	1	1	0	0.0
Nick_McKoy	wikicat_Living_people	1	1	0	0.0
Podlaskie_Voivodeship	wordnet_administrative_district_108491826	2	2	0	0.0
Partick_Thistle_F.C.	wikicat_Football_clubs_in_Scotland	1	1	0	0.0
Western_New_York_Flash	wordnet_club_108227214	1	1	0	0.0
FC_Chernomorets_Novorossiysk	wordnet_club_108227214	1	1	0	0.0
Adana	wikicat_Roman_sites_in_Turkey	1	1	0	0.0
Germán_Pietrobon	wikicat_Bulgarian_A_Professional_Football_Group_players	1	1	0	0.0
Andy_Webster	wikicat_Living_people	1	1	0	0.0
South_East_England	wikicat_Regions_of_England	1	1	0	0.0
Mvondo_Atangana	wikicat_Scottish_Premier_League_players	1	1	0	0.0
Felix_Ogbuke	wikicat_Expatriate_footballers_in_Cyprus	1	1	0	0.0
Talia_Shire	wikicat_Actors	1	1	0	0.0
Alicia_Silverstone	wordnet_person_100007846	1	1	0	0.0
Godfrey_Ingram	wikicat_Living_people	1	1	0	0.0
Republic_of_Ireland_national_under-21_football_team	wordnet_football_team_108080025	1	1	0	0.0
Thiago_Ramos_Fernandes	wikicat_Liga_I_players	1	1	0	0.0
Gustavo_Biscayzacú	wikicat_Expatriate_footballers_in_Mexico	3	3	0	0.0
Javier_Marías	wordnet_writer_110794014	1	1	0	0.0
Mircea_Rednic	wikicat_Romanian_footballers	2	2	0	0.0
Filmfare_Awards	wikicat_Awards_established_in_1954	1	1	0	0.0
Ecuador	wikicat_Countries	1	1	0	0.0
Clinton_County,_Indiana	wikicat_Populated_places_established_in_1830	1	1	0	0.0
University_of_Sussex	wordnet_university_108286569	1	1	0	0.0
Stephan_Kling	wikicat_Living_people	1	1	0	0.0
MO_Constantine	wikicat_Football_clubs_in_Algeria	1	1	0	0.0
Italian_Socialist_Party	wikicat_Defunct_political_parties	1	1	0	0.0
F.C._Zenit_St._Petersburg	wikicat_Football_clubs_in_Russia	1	1	0	0.0
Michael_Hughes_(footballer)	wikicat_Living_people	1	1	0	0.0
Comoé_Province	wikicat_Subdivisions_of_Burkina_Faso	1	1	0	0.0
Michal_Kubala	wikicat_Expatriate_footballers_in_Romania	1	1	0	0.0
Matthew_Bellamy	wikicat_English_rock_guitarists	4	4	0	0.0
Jane_Wyman	wikicat_American_television_actresses	1	1	0	0.0
Iván_Obolo	wikicat_Argentine_footballers	1	1	0	0.0
Wiener_Sport-Club	wordnet_club_108227214	1	1	0	0.0
Lethbridge_Hurricanes	wordnet_team_108208560	2	2	0	0.0
Montrouge	wikicat_Cities_in_France	1	1	0	0.0
Tampa	wikicat_Cities_in_Florida	1	1	0	0.0
Steve_Book	wikicat_Cheltenham_Town_F.C._players	1	1	0	0.0
Africa	wordnet_continent_109254614	1	1	0	0.0
Nico_Claesen	wikicat_Royal_Antwerp_F.C._players	2	2	0	0.0
Ben_Wright_(footballer_born_1980)	wikicat_English_footballers	1	1	0	0.0
Oscar_Dertycia	wikicat_Argentine_footballers	1	1	0	0.0
Mark_Owen	wikicat_English_singers	1	1	0	0.0
Wassily_Leontief	wikicat_Nobel_laureates_in_Economics	1	1	0	0.0
Uganda	wikicat_Landlocked_countries	2	2	0	0.0
Steven_Weinberg	wikicat_American_people	1	1	0	0.0
Lithuania_national_football_team	wikicat_European_national_association_football_teams	2	2	0	0.0
NK_Kamen_Ingrad	wikicat_Association_football_clubs_disestablished_in_2008	1	1	0	0.0
Charlotte_Rampling	wikicat_20th-century_actors	1	1	0	0.0
Wallace_Shawn	wikicat_American_voice_actors	7	7	0	0.0
Joseph-Désiré_Job	wikicat_2002_FIFA_World_Cup_players	1	1	0	0.0
Fernando_Sales	wikicat_Segunda_División_footballers	2	2	0	0.0
Manitoba	wordnet_district_108552138	4	4	0	0.0
Marion_Zimmer_Bradley	wikicat_English-language_writers	1	1	0	0.0
Gustavo_Napoles	wikicat_Club_América_footballers	3	3	0	0.0
Richmond_Boakye	wikicat_Ghana_international_footballers	1	1	0	0.0
Castries	wordnet_administrative_district_108491826	1	1	0	0.0
Reus_Airport	wikicat_Airports_in_Spain	1	1	0	0.0
Geert_den_Ouden	wikicat_Expatriate_footballers_in_Sweden	2	2	0	0.0
Ricky_Gervais	wikicat_English_film_actors	2	2	0	0.0
Steve_Collis	wikicat_Torquay_United_F.C._players	1	1	0	0.0
Frosinone_Calcio	wikicat_Serie_B_clubs	1	1	0	0.0
Kloten	wordnet_town_108665504	1	1	0	0.0
Walker_Percy	wordnet_writer_110794014	1	1	0	0.0
Vranov_nad_Topľou_District	wordnet_district_108552138	1	1	0	0.0
DeFuniak_Springs,_Florida	wikicat_County_seats_in_Florida	1	1	0	0.0
Turku	wikicat_Port_cities_and_towns_of_the_Baltic_Sea	1	1	0	0.0
Zlatan_Ibrahimović	wikicat_Serie_A_footballers	1	1	0	0.0
Smith_College	wordnet_university_108286569	1	1	0	0.0
Chhunly_Pagenburg	wikicat_German_footballers	1	1	0	0.0
Vicenza	wikicat_Cities_and_towns_in_Veneto	1	1	0	0.0
Nargis	wikicat_Actors	1	1	0	0.0
Isabella_II_of_Spain	wikicat_Women	1	1	0	0.0
Saunders_Mac_Lane	wordnet_scientist_110560637	1	1	0	0.0
Coventry_City_F.C.	wikicat_Football_League_clubs	1	1	0	0.0
Burkina_Faso	wikicat_Least_developed_countries	1	1	0	0.0
Thomas_Paine	wordnet_philosopher_110423589	2	2	0	0.0
Parral_(footballer)	wikicat_Brazilian_footballers	1	1	0	0.0
Colchester	wikicat_Towns_in_Essex	1	1	0	0.0
FC_Dnepr_Mogilev	wikicat_Football_clubs_in_the_Soviet_Union	1	1	0	0.0
Sevilla_F.C.	wikicat_La_Liga_clubs	1	1	0	0.0
Marques_Houston	wikicat_Actors	1	1	0	0.0
Nicolás_Muñoz	wikicat_Expatriate_footballers_in_El_Salvador	1	1	0	0.0
Daniel_Craig	wikicat_20th-century_actors	1	1	0	0.0
Chiba	wikicat_Populated_coastal_places_in_Japan	1	1	0	0.0
1._FC_Köln	wordnet_club_108227214	1	1	0	0.0
Sunil_Dutt	wikicat_Indian_film_directors	1	1	0	0.0
Sanjay_Dutt	wikicat_Actors	1	1	0	0.0
Irapuato_FC	wikicat_Ascenso_MX_teams	3	3	0	0.0
Bob_Hope	wikicat_American_comedians	1	1	0	0.0
Kim_Dae-eui	wikicat_Living_people	1	1	0	0.0
Kano	wikicat_State_capitals_in_Nigeria	1	1	0	0.0
Fulham_F.C.	wikicat_Football_clubs_in_London	1	1	0	0.0
Josiesley_Ferreira_Rosa	wikicat_Expatriate_footballers_in_Portugal	1	1	0	0.0
Eindhoven	wikicat_Municipalities_of_North_Brabant	1	1	0	0.0
Évry,_Essonne	wikicat_Cities_in_France	1	1	0	0.0
Andy_Millen	wikicat_Scottish_footballers	1	1	0	0.0
Elie_Aiboy	wikicat_Expatriate_footballers_in_Malaysia	1	1	0	0.0
ASO_Chlef	wikicat_Algerian_Ligue_Professionnelle_1_clubs	1	1	0	0.0
Latvia	wikicat_Countries	1	1	0	0.0
Istria_County	wikicat_Italian-speaking_countries_and_territories	1	1	0	0.0
Dorin_Goian	wikicat_Living_people	1	1	0	0.0
Brendan_Fraser	wikicat_20th-century_actors	1	1	0	0.0
Capital_Region_of_Denmark	wikicat_States_and_territories_established_in_2007	1	1	0	0.0
Jack_Cork	wikicat_Living_people	1	1	0	0.0
Thiago_Maciel	wikicat_Brazilian_footballers	1	1	0	0.0
Portuguese_Empire	wikicat_Former_empires	1	1	0	0.0
Billy_Corgan	wikicat_American_male_singers	1	1	0	0.0
Cagliari	wikicat_Port_cities	1	1	0	0.0
Mexican_Drug_War	wordnet_conflict_100958896	1	1	0	0.0
Saunders_Mac_Lane	wikicat_American_mathematicians	1	1	0	0.0
Syria	wikicat_Arabic-speaking_countries_and_territories	1	1	0	0.0
South_Africa	wikicat_English-speaking_countries_and_territories	1	1	0	0.0
Altenburg	wordnet_location_100027167	1	1	0	0.0
Laurent_Schwartz	wordnet_scientist_110560637	1	1	0	0.0
Rwanda	wikicat_French-speaking_countries_and_territories	1	1	0	0.0
South_Carolina	wikicat_States_of_the_United_States	1	1	0	0.0
Leonid_Hurwicz	wikicat_American_people	1	1	0	0.0
Pablo_Aimar	wikicat_La_Liga_footballers	1	1	0	0.0
Zhuhai_Jinwan_Airport	wordnet_airport_102692232	1	1	0	0.0
Université_de_Montréal	wordnet_university_108286569	1	1	0	0.0
Democratic_Party_(United_States)	wikicat_Liberal_parties	1	1	0	0.0
Ottoman_Empire	wikicat_Empires	1	1	0	0.0
Gamba_Osaka	wikicat_J._League_clubs	1	1	0	0.0
Juan_Carlos_Silva	wikicat_Mexican_footballers	7	7	0	0.0
Hristo_Stoichkov	wikicat_Expatriate_soccer_players_in_the_United_States	1	1	0	0.0
Bahrain	wordnet_country_108544813	1	1	0	0.0
HNK_Hajduk_Split	wordnet_club_108227214	1	1	0	0.0
Ernst_Dospel	wikicat_Austrian_footballers	1	1	0	0.0
Serhiy_Zakarlyuka	wikicat_Ukrainian_footballers	1	1	0	0.0
Olivier_Martinez	wikicat_French_people	1	1	0	0.0
Henry_Fonda	wikicat_Western_(genre)_film_actors	1	1	0	0.0
Kathy_Bates	wikicat_American_television_actors	1	1	0	0.0
Dick_Cheney	wordnet_officeholder_110371450	1	1	0	0.0
Club_Sol_de_América	wordnet_club_108227214	1	1	0	0.0
Dennis_Miller	wikicat_American_people	1	1	0	0.0
United_States_women's_national_soccer_team	wordnet_football_team_108080025	1	1	0	0.0
Michel_Debré	wordnet_officeholder_110371450	1	1	0	0.0
Charlie_Chaplin	wikicat_English_screenwriters	2	2	0	0.0
Liberia	wikicat_Member_states_of_the_African_Union	1	1	0	0.0
Highlanders_(rugby_union)	wordnet_team_108208560	1	1	0	0.0
Forfar_Athletic_F.C.	wordnet_club_108227214	1	1	0	0.0
Bruno_Cirillo	wikicat_Expatriate_footballers_in_Spain	1	1	0	0.0
Milan_Stojanoski	wikicat_Macedonian_expatriate_footballers	3	3	0	0.0
Tommy_Wright_(footballer,_born_1984)	wikicat_English_footballers	1	1	0	0.0
Lin_Carter	wordnet_writer_110794014	1	1	0	0.0
Namur,_Belgium	wordnet_municipality_108626283	1	1	0	0.0
Nicolas_Anelka	wikicat_Süper_Lig_players	1	1	0	0.0
Spezia_Calcio	wikicat_Lega_Pro_Prima_Divisione_clubs	2	2	0	0.0
Ricardo_Montalbán	wordnet_person_100007846	2	2	0	0.0
Edmonton	wikicat_Towns_in_Alberta	1	1	0	0.0
Marcos_Alonso_Peña	wikicat_Living_people	1	1	0	0.0
San_Diego	wikicat_Incorporated_cities_and_towns_in_California	1	1	0	0.0
Thelma_Schoonmaker	wordnet_person_100007846	2	2	0	0.0
Mato_Neretljak	wikicat_Croatia_international_footballers	2	2	0	0.0
Barnsley_F.C.	wikicat_Premier_League_clubs	1	1	0	0.0
University_of_Notre_Dame	wikicat_Atlantic_Coast_Conference_schools	14330	14336	-6	-0.000418702023726448
Robbie_Herrera	wikicat_Taunton_Town_F.C._players	13563	13569	-6	-0.00044238000442380006
Wisconsin	wikicat_States_and_territories_established_in_1848	14361	14369	-8	-0.0005570642712903001
Mohali_district	wikicat_Districts_of_Punjab,_India	12329	12337	-8	-0.0006488766323302783
Leon_Trotsky	wikicat_People_of_the_1905_Russian_Revolution	15834	15847	-13	-0.0008210180623973727
Daniel_Dennett	wikicat_Phillips_Exeter_Academy_alumni	16065	16088	-23	-0.0014316837846249611
Tupac_Shakur	wikicat_20th-century_American_poets	867	869	-2	-0.002306805074971165
Nikola_Karčev	wikicat_FK_Metalac_Gornji_Milanovac_players	14138	14177	-39	-0.0027585231291554677
Malpensa_Airport	wikicat_Airports_established_in_1909	12798	12852	-54	-0.004219409282700422
Mylène_Farmer	wikicat_Musicians_from_Montreal	14765	14830	-65	-0.0044023027429732475
Tyra_Banks	wikicat_Artists_from_California	1213	1219	-6	-0.00494641384995878
Manuel_Preciado_Rebolledo	wikicat_Sporting_de_Gijón_managers	12755	12819	-64	-0.005017640141121129
Duchy_of_Styria	wikicat_States_and_territories_established_in_the_12th_century	15189	15268	-79	-0.005201132398446244
Olivia_Newton-John	wikicat_Australian_people_of_German_descent	16751	16844	-93	-0.005551907348814996
Artavazd_Karamyan	wikicat_Armenian_expatriates_in_Romania	14544	14625	-81	-0.005569306930693069
Saint-Jérôme,_Quebec	wikicat_Municipalities_in_Quebec	11537	11602	-65	-0.005634046979284043
Masaru_Sato	wikicat_Japanese_film_score_composers	16411	16506	-95	-0.005788800194991164
Celebes_Sea	wikicat_Bodies_of_water_of_the_Philippines	14117	14214	-97	-0.006871148260961961
Lucero_(entertainer)	wikicat_Mexican_stage_actresses	12956	13046	-90	-0.006946588453226305
Jamie_Moralee	wikicat_Crewe_Alexandra_F.C._players	255	257	-2	-0.00784313725490196
Jim_Adams_(soccer)	wikicat_Kansas_City_Attack_(NPSL)_players	12836	12941	-105	-0.008180118416952322
Mahesh_Babu	wikicat_Telugu_male_actors	15342	15471	-129	-0.008408290965975753
Oleg_Dolmatov	wikicat_FC_Dynamo_Saint_Petersburg_managers	16449	16600	-151	-0.009179889354975986
Phil_Keaggy	wikicat_Fingerstyle_guitarists	16427	16585	-158	-0.009618311316734645
Birmingham,_Michigan	wikicat_Cities_in_Oakland_County,_Michigan	16238	16398	-160	-0.009853430225397216
Sissy_Spacek	wikicat_American_people_of_Czech_descent	997	1007	-10	-0.010030090270812437
Dieter_Van_Tornhout	wikicat_People_from_Ghent	14740	14901	-161	-0.010922659430122116
50_Cent	wikicat_Shoe_designers	15713	15902	-189	-0.01202825685737924
Xavier_Gravelaine	wikicat_SM_Caen_players	78	79	-1	-0.01282051282051282
Ethio-Somali_War	wikicat_Wars_involving_Yemen	10013	10143	-130	-0.012983121941476081
Tarbes	wikicat_Communes_of_Hautes-Pyrénées	12073	12243	-170	-0.014081007206162512
Olivia_Newton-John	wikicat_People_of_Welsh_descent	69	70	-1	-0.014492753623188406
Craig_David	wikicat_People_from_Southampton	15114	15342	-228	-0.015085351329892815
Gary_Moore	wikicat_Blues_musicians	188	191	-3	-0.015957446808510637
University_College_Dublin	wikicat_Universities_and_colleges_in_the_Republic_of_Ireland	11327	11516	-189	-0.016685795003089962
Montgomery_Clift	wikicat_LGBT_people	416	423	-7	-0.016826923076923076
Romford	wikicat_Post_towns_in_the_RM_postcode_area	16775	17058	-283	-0.016870342771982117
Alessio_Cerci	wikicat_Italy_youth_international_footballers	57	58	-1	-0.017543859649122806
Eric_Clapton	wikicat_Blues_guitarists	16483	16794	-311	-0.018867924528301886
James_Wong_(lyricist)	wikicat_Hong_Kong_writers	14254	14523	-269	-0.018871895608250314
Kalusha_Bwalya	wikicat_Zambian_expatriate_footballers	12453	12692	-239	-0.019192162531117
Joshua_Jackson	wikicat_American_male_child_actors	155	158	-3	-0.01935483870967742
Nicollette_Sheridan	wikicat_People_from_West_Sussex	15001	15294	-293	-0.01953203119792014
Frank_Launder	wikicat_People_from_Hertfordshire	14908	15202	-294	-0.019720955191843307
Monty_Python	wikicat_Charisma_Records_artists	15249	15551	-302	-0.01980457734933438
Chris_Coyne	wikicat_Luton_Town_F.C._players	343	350	-7	-0.02040816326530612
Abel_Xavier	wikicat_Hannover_96_players	193	197	-4	-0.02072538860103627
Kathy_Bates	wikicat_People_with_cancer	16408	16749	-341	-0.020782545099951245
Moscow_State_University	wikicat_Universities_in_Moscow	14897	15213	-316	-0.02121232462911996
Dave_Mitchell_(footballer)	wikicat_Seiko_players	14898	15215	-317	-0.021278023895824942
Henry_León	wikicat_Independiente_José_Terán_footballers	15395	15724	-329	-0.02137057486196817
Mikel_Arce	wikicat_CD_Constancia_footballers	13658	13959	-301	-0.022038365792941866
Roald_Dahl	wikicat_British_aviators	15250	15598	-348	-0.02281967213114754
Lisa_De_Vanna	wikicat_Linköpings_FC_players	219	224	-5	-0.0228310502283105
John_Adams	wikicat_People_from_Quincy,_Massachusetts	12786	13085	-299	-0.023384952291568905
Delta_Goodrem	wikicat_Australian_songwriters	42	43	-1	-0.023809523809523808
Fernando_Fernández_Escribano	wikicat_Diósgyőri_VTK_footballers	13985	14318	-333	-0.02381122631390776
Ryan_Miller_(soccer)	wikicat_Soccer_players_from_Illinois	14323	14672	-349	-0.024366403686378553
Milovan_Milović	wikicat_FK_Javor_Ivanjica_players	40	41	-1	-0.025
Gaston_Doumergue	wikicat_Knights_of_the_Elephant	39	40	-1	-0.02564102564102564
Óscar_Alcides_Mena	wikicat_Atlético_Madrid_footballers	78	80	-2	-0.02564102564102564
Mircea_Rednic	wikicat_Al-Nassr_FC_managers	13703	14056	-353	-0.02576078231044297
Bret_McKenzie	wikicat_Officers_of_the_New_Zealand_Order_of_Merit	13139	13482	-343	-0.02610548748002131
Kapurthala_district	wikicat_Districts_of_Punjab,_India	12798	13146	-348	-0.02719174871073605
Vaduz	wikicat_Subdivisions_of_Liechtenstein	15904	16338	-434	-0.027288732394366196
Gerry_Britton	wikicat_Livingston_F.C._players	36	37	-1	-0.027777777777777776
Dune_(film)	wikicat_1980s_science_fiction_films	36	37	-1	-0.027777777777777776
Burkhard_Segler	wikicat_1._FC_Bocholt_players	16026	16480	-454	-0.02832896543117434
Harvard_Business_School	wikicat_Business_schools_in_Massachusetts	13007	13377	-370	-0.028446221265472436
California	wikicat_States_and_territories_established_in_1850	16555	17035	-480	-0.028994261552401087
Jim_Rodwell	wikicat_Rushden_&amp;_Diamonds_F.C._players	33	34	-1	-0.030303030303030304
Jerzy_Skolimowski	wikicat_Polish_actors	15481	15952	-471	-0.030424391189199665
Kid_Rock	wikicat_American_libertarians	1461	1506	-45	-0.030800821355236138
Canterbury	wikicat_Post_towns_in_the_CT_postcode_area	14256	14697	-441	-0.030934343434343436
Lindsay_Lohan	wikicat_American_people_of_Irish_descent	32	33	-1	-0.03125
Jacques_Chirac	wikicat_Agriculture_ministers	1666	1719	-53	-0.03181272509003601
Luis_Flores_(basketball)	wikicat_Basketball_players_from_New_York	15201	15699	-498	-0.03276100256562068
Ben_Davis_(basketball)	wikicat_Makedonikos_B.C._players	15845	16369	-524	-0.033070369201640894
Foeke_Booy	wikicat_Al-Nassr_FC_managers	16314	16858	-544	-0.03334559274242981
Filmfare_Awards	wikicat_Indian_awards	15572	16098	-526	-0.03377857693295659
Altrincham_F.C.	wikicat_Association_football_clubs_established_in_1891	1670	1727	-57	-0.03413173652694611
Handball_Club_Leipzig	wikicat_Sports_clubs_established_in_1893	261	270	-9	-0.034482758620689655
Yorkshire_Dales	wikicat_National_parks_of_England_and_Wales	14076	14573	-497	-0.03530832622904234
Georg_Wilhelm_Friedrich_Hegel	wikicat_Philosophers_of_education	442	458	-16	-0.03619909502262444
Nanning_Wuxu_International_Airport	wikicat_Airports_established_in_1962	15462	16024	-562	-0.03634717371620748
Raul_Águas	wikicat_C.S._Marítimo_managers	14994	15541	-547	-0.036481259170334804
Robert_Robinson_(organic_chemist)	wikicat_Faraday_Lecturers	27	28	-1	-0.037037037037037035
Eugène_Ionesco	wikicat_French_people_of_Greek_descent	7493	7772	-279	-0.03723475243560657
Barack_Obama	wikicat_American_people_of_Swiss_descent	716	743	-27	-0.03770949720670391
Cruzeiro_Esporte_Clube	wikicat_Football_clubs_in_Belo_Horizonte	11151	11573	-422	-0.03784413953905479
Serhiy_Rozhok	wikicat_FC_Kryvbas_Kryvyi_Rih_players	26	27	-1	-0.038461538461538464
Michał_Kalecki	wikicat_Polish_economists	26	27	-1	-0.038461538461538464
Tyra_Banks	wikicat_LGBT_rights_activists_from_the_United_States	26	27	-1	-0.038461538461538464
Jean-Luc_Godard	wikicat_Swiss_film_directors	14823	15407	-584	-0.0393982324765567
Jeremiah_Denton	wikicat_Naval_War_College_alumni	15388	15995	-607	-0.039446321809201976
Oklahoma_City	wikicat_Cities_in_Cleveland_County,_Oklahoma	16584	17253	-669	-0.040340086830680175
LL_Cool_J	wikicat_Def_Jam_Recordings_artists	14817	15417	-600	-0.04049402713099818
Abruzzo	wikicat_States_and_territories_established_in_1963	10988	11434	-446	-0.04058973425555151
Søren_Kierkegaard	wikicat_Christian_ethicists	15343	15966	-623	-0.04060483608160073
Prince_Philip,_Duke_of_Edinburgh	wikicat_People_educated_at_Gordonstoun	16505	17179	-674	-0.04083611026961527
Jean-Luc_Godard	wikicat_French_film_editors	14767	15377	-610	-0.04130832261122774
M._T._Vasudevan_Nair	wikicat_Indian_short_story_writers	13968	14548	-580	-0.04152348224513173
Pierre_Pflimlin	wikicat_People_from_Alsace	6653	6934	-281	-0.04223658499924846
Jim_Adams_(soccer)	wikicat_Delaware_Wizards_players	12386	12910	-524	-0.04230582916195705
Hichem_Mezaïr	wikicat_WA_Tlemcen_players	15467	16154	-687	-0.04441714618219435
Barry_Manilow	wikicat_American_crooners	176	184	-8	-0.045454545454545456
Vladimir_Chelomey	wikicat_Kyiv_Polytechnic_Institute_alumni	14968	15651	-683	-0.04563067878140032
Jean-Emmanuel_Effa_Owona	wikicat_Cameroonian_expatriates_in_Qatar	14818	15501	-683	-0.04609259009312998
Pittsburgh	wikicat_Pennsylvania_populated_places_on_the_Ohio_River	12928	13526	-598	-0.04625618811881188
Giuseppe_Sannino	wikicat_Watford_F.C._managers	14945	15641	-696	-0.04657075945132151
André_Weil	wikicat_Aligarh_Muslim_University_alumni	16592	17368	-776	-0.0467695274831244
Frank_Morgan	wikicat_Stage_actors	42	44	-2	-0.047619047619047616
Leonid_Hurwicz	wikicat_Russian_economists	41	43	-2	-0.04878048780487805
Ljungskile_SK	wikicat_Football_clubs_in_Sweden	14591	15320	-729	-0.04996230553080666
Kamel_Larbi	wikicat_US_Sénart-Moissy_players	16041	16848	-807	-0.05030858425285207
New_Haven,_Connecticut	wikicat_Cities_in_New_Haven_County,_Connecticut	12752	13395	-643	-0.05042346298619824
George_Best	wikicat_Fort_Lauderdale_Strikers_(1977–83)_players	13866	14586	-720	-0.05192557334487235
Sevnica	wikicat_Cities_and_towns_in_Styria_(Slovenia)	12999	13675	-676	-0.05200400030771598
Chuck_Norris	wikicat_American_martial_artists	13510	14213	-703	-0.052035529237601776
Stephenie_Meyer	wikicat_American_children's_writers	268	282	-14	-0.05223880597014925
Ashgabat	wikicat_Provinces_of_Turkmenistan	15347	16153	-806	-0.05251840750635303
George_Berkeley	wikicat_Philosophers_of_science	19	20	-1	-0.05263157894736842
Keanu_Reeves	wikicat_Canadian_people_of_Chinese_descent	16668	17561	-893	-0.053575713942884566
Aristide_Briand	wikicat_People_from_Nantes	13990	14744	-754	-0.053895639742673335
Bruno_Simão	wikicat_Expatriate_footballers_in_Slovakia	74	78	-4	-0.05405405405405406
John_F._Kennedy	wikicat_Roman_Catholic_heads_of_government	15792	16651	-859	-0.054394630192502534
Ersin_Mehmedović	wikicat_FC_Unirea_Urziceni_players	182	192	-10	-0.054945054945054944
Matt_Taylor_(footballer)	wikicat_Charlton_Athletic_F.C._players	91	96	-5	-0.054945054945054944
Martin_Rees,_Baron_Rees_of_Ludlow	wikicat_People_from_York	15533	16387	-854	-0.05497972059486255
Sylvia_Plath	wikicat_Glascock_Prize_winners	14114	14891	-777	-0.05505172169477115
Delta_Goodrem	wikicat_Singers_from_Sydney	12512	13215	-703	-0.05618606138107417
University_of_Calgary	wikicat_Educational_institutions_established_in_1966	13664	14448	-784	-0.05737704918032787
Chien-Shiung_Wu	wikicat_Writers_from_Shanghai	10124	10706	-582	-0.057487159225602526
Republican_Party_(United_States)	wikicat_Political_parties_established_in_1854	13469	14246	-777	-0.0576880243522162
Hussein_of_Jordan	wikicat_People_from_Amman	15369	16258	-889	-0.057843711367037545
Antonio_Rizzolo	wikicat_Ternana_Calcio_players	85	90	-5	-0.058823529411764705
Sarah_Huffman	wikicat_Expatriate_footballers_in_Norway	34	36	-2	-0.058823529411764705
Stan_Laurel	wikicat_Hal_Roach_Studios_actors	14342	15199	-857	-0.05975456700599637
Debbie_Reynolds	wikicat_Actresses_from_Texas	516	547	-31	-0.060077519379844964
Lionel_Messi	wikicat_FIFA_World_Cup_players	15420	16348	-928	-0.06018158236057069
Richard_Dawkins	wikicat_British_secularists	488	518	-30	-0.06147540983606557
Shpëtim_Babaj	wikicat_People_from_Pristina	15250	16189	-939	-0.06157377049180328
Luis_García_(footballer,_born_1978)	wikicat_Atlético_Madrid_footballers	16	17	-1	-0.0625
Dan_Aykroyd	wikicat_Canadian_male_comedians	16	17	-1	-0.0625
Rosa_Luxemburg	wikicat_Assassinated_politicians	48	51	-3	-0.0625
David_Coverdale	wikicat_People_from_North_Yorkshire	4491	4772	-281	-0.06256958361166778
Steven_Pelé	wikicat_CFM_U_Cluj_players	205	218	-13	-0.06341463414634146
John_W._Campbell_Memorial_Award_for_Best_Science_Fiction_Novel	wikicat_Awards_established_in_1973	14104	15000	-896	-0.06352807714123652
Beaufort,_South_Carolina	wikicat_Populated_places_in_Beaufort_County,_South_Carolina	9995	10632	-637	-0.06373186593296648
King_Khalid_International_Airport	wikicat_Airports_in_Saudi_Arabia	14930	15912	-982	-0.06577361018084393
Sebastian_Helbig	wikicat_FC_Energie_Cottbus_players	30	32	-2	-0.06666666666666667
Artavazd_Karamyan	wikicat_FC_Rapid_București_players	30	32	-2	-0.06666666666666667
Líder_Mármol	wikicat_Club_Sol_de_América_footballers	75	80	-5	-0.06666666666666667
Syarhey_Kuznyatsow	wikicat_FC_Dinamo_Brest_players	13713	14637	-924	-0.06738131699846861
Zlatan_Ibrahimović	wikicat_A.C._Milan_players	293	313	-20	-0.06825938566552901
Houston	wikicat_Capitals_of_former_nations	29	31	-2	-0.06896551724137931
Arthur_Moses	wikicat_Ghanaian_expatriates_in_Nigeria	12273	13123	-850	-0.0692577201988104
Bill_Evans	wikicat_Riverside_Records_artists	14680	15709	-1029	-0.07009536784741144
Guy_Feutchine	wikicat_Kallithea_F.C._players	1196	1281	-85	-0.07107023411371237
Lee_Chapman	wikicat_Expatriate_footballers_in_Norway	14	15	-1	-0.07142857142857142
Gianfranco_Labarthe	wikicat_Huddersfield_Town_F.C._players	14	15	-1	-0.07142857142857142
Awvee_Storey	wikicat_New_Yorker_Phantoms_Braunschweig_players	14	15	-1	-0.07142857142857142
Luís_Eduardo_Schmidt	wikicat_Brazilian_people_of_German_descent	13130	14068	-938	-0.07143945163747144
Vladimir_Chelomey	wikicat_Early_spaceflight_scientists	14258	15294	-1036	-0.0726609622667976
Amartya_Sen	wikicat_Feminist_economists	14126	15159	-1033	-0.07312756619000425
Prince_Philip,_Duke_of_Edinburgh	wikicat_British_royal_consorts	16241	17430	-1189	-0.07320977772304661
Nokia	wikicat_Electronics_companies	12551	13480	-929	-0.07401800653334396
Sanchez_Watt	wikicat_Arsenal_F.C._players	67	72	-5	-0.07462686567164178
Jim_Adams_(soccer)	wikicat_Cincinnati_Excite_players	14841	15965	-1124	-0.0757361363789502
Rhenen	wikicat_Subdivisions_of_the_Netherlands	13506	14544	-1038	-0.07685473123056419
Oleh_Taran	wikicat_FC_Metalurh_Zaporizhya_players	13	14	-1	-0.07692307692307693
UB_Conquense	wikicat_Football_clubs_in_Spain	380	410	-30	-0.07894736842105263
Craig_Beattie	wikicat_Association_football_forwards	25	27	-2	-0.08
Germany	wikicat_Federal_countries	25	27	-2	-0.08
Faith_Evans	wikicat_American_hip_hop_singers	25	27	-2	-0.08
Gary_Cole	wikicat_People_from_Park_Ridge,_Illinois	15120	16366	-1246	-0.0824074074074074
Minnesota	wikicat_States_and_territories_established_in_1858	12217	13227	-1010	-0.0826716869935336
Miloš_Kolaković	wikicat_Expatriate_footballers_in_Hungary	12	13	-1	-0.08333333333333333
Roque_Santa_Cruz	wikicat_Paraguay_international_footballers	36	39	-3	-0.08333333333333333
Weston-super-Mare_A.F.C.	wikicat_Southern_Football_League_clubs	12	13	-1	-0.08333333333333333
Manuel_Preciado_Rebolledo	wikicat_Racing_de_Santander_footballers	24	26	-2	-0.08333333333333333
Will_Gregory	wikicat_British_synthpop_new_wave_musicians	24	26	-2	-0.08333333333333333
Athens	wikicat_Ancient_Greek_sites_in_Greece	14912	16164	-1252	-0.08395922746781116
Serghei_Rogaciov	wikicat_FC_Sheriff_Tiraspol_players	1173	1272	-99	-0.08439897698209718
Anthony_Eden	wikicat_Younger_sons_of_baronets	15126	16416	-1290	-0.0852836176120587
Carlos_Pavón	wikicat_Expatriate_footballers_in_Guatemala	210	228	-18	-0.08571428571428572
Bret_McKenzie	wikicat_New_Zealand_male_comedians	12068	13116	-1048	-0.08684123301292675
Alan_Ladd	wikicat_People_from_Hot_Springs,_Arkansas	12555	13661	-1106	-0.08809239346873755
Netanya	wikicat_Populated_places_established_in_1928	10937	11901	-964	-0.08814117216787053
George_R._R._Martin	wikicat_American_conscientious_objectors	15440	16807	-1367	-0.08853626943005181
Louisiana	wikicat_States_and_territories_established_in_1812	13888	15125	-1237	-0.08906970046082949
Rachel_Weisz	wikicat_English_female_models	12551	13669	-1118	-0.08907656760417497
Uche_Akubuike	wikicat_Sharks_F.C._players	14036	15308	-1272	-0.09062410943288686
Donald_Crisp	wikicat_English_screenwriters	22	24	-2	-0.09090909090909091
George_W._Bush	wikicat_American_people_of_French_descent	33	36	-3	-0.09090909090909091
Jeremiah_Denton	wikicat_Vietnam_War_prisoners_of_war	11	12	-1	-0.09090909090909091
Miklós_Horthy	wikicat_Austro-Hungarian_people_of_World_War_I	15402	16823	-1421	-0.09226074535774574
Oscar_Hammerstein_II	wikicat_Lyricists	65	71	-6	-0.09230769230769231
Roman_Eremenko	wikicat_Finnish_people_of_Ukrainian_descent	14383	15721	-1338	-0.0930264896057846
Ely_Thadeu	wikicat_Esporte_Clube_Democrata_players	13608	14886	-1278	-0.09391534391534391
Mohd_Nazrulerwan_Makmor	wikicat_Malaysian_footballers	14928	16342	-1414	-0.09472132904608789
Mike_Myers	wordnet_actor_109765278	15885	17408	-1523	-0.09587661315706641
Bill_Evans	wikicat_Bebop_musicians	13468	14762	-1294	-0.09607959607959608
Eddie_Basden	wikicat_Charlotte_49ers_men's_basketball_players	13803	15130	-1327	-0.09613852061146128
Roberto_Pompei	wikicat_Huracán_footballers	31	34	-3	-0.0967741935483871
Panama_City	wikicat_Port_cities	51	56	-5	-0.09803921568627451
Guy_Feutchine	wikicat_Cameroonian_expatriates_in_Poland	11299	12412	-1113	-0.09850429241525799
Alice_Munro	wikicat_Canadian_novelists	15001	16479	-1478	-0.09852676488234118
Kalamata_F.C.	wikicat_Association_football_clubs_established_in_1967	3582	3936	-354	-0.09882747068676717
Neil_Jordan	wikicat_People_of_the_Year_Awards_winners	15724	17287	-1563	-0.09940218773848894
Montevideo	wikicat_Populated_places_in_Uruguay	13409	14745	-1336	-0.09963457379372063
Felix_Halfon	wikicat_Israel_under-21_international_footballers	10	11	-1	-0.1
Tony_Curtis	wikicat_Actors_from_California	60	66	-6	-0.1
Buenos_Aires	wikicat_Populated_coastal_places_in_Argentina	13308	14647	-1339	-0.10061617072437631
Fábio_Bilica	wikicat_U.S._Città_di_Palermo_players	434	478	-44	-0.10138248847926268
Craig_Nelson_(footballer)	wikicat_People_from_Coatbridge	14933	16447	-1514	-0.10138619165606375
Ryan_Mack	wikicat_Xtreme_Soccer_League_players	14762	16260	-1498	-0.10147676466603442
Augsburg	wikicat_Archaeological_sites_in_Germany	14594	16083	-1489	-0.10202823077977251
Bret_McKenzie	wikicat_New_Zealand_actors	14463	15949	-1486	-0.10274493535227823
Miloš_Dimitrijević	wikicat_Grenoble_Foot_38_players	87	96	-9	-0.10344827586206896
Samuel_R._Delany	wikicat_Writers_from_Philadelphia,_Pennsylvania	13710	15140	-1430	-0.10430342815463166
Michael_Nyman	wikicat_Postmodern_composers	14888	16443	-1555	-0.10444653412144009
Andriy_Raspopov	wikicat_FC_Granit_Mikashevichi_players	67	74	-7	-0.1044776119402985
Chuck_Norris	wikicat_American_political_pundits	553	611	-58	-0.10488245931283906
Al-Sailiya_SC	wikicat_Football_clubs_in_Qatar	7227	8004	-777	-0.10751349107513491
Peter_Kropotkin	wikicat_Russian_anarchists	14075	15591	-1516	-0.10770870337477798
Germany	wikicat_States_and_territories_established_in_1871	211	234	-23	-0.10900473933649289
Winchester,_Virginia	wordnet_county_108546183	3723	4132	-409	-0.10985764168681171
Özden_Öngün	wikicat_MKE_Ankaragücü_footballers	9	10	-1	-0.1111111111111111
Denis_Leary	wikicat_American_screenwriters	9	10	-1	-0.1111111111111111
Daniel_Majstorović	wikicat_AIK_Fotboll_players	27	30	-3	-0.1111111111111111
Paulette_Goddard	wikicat_American_film_producers	53	59	-6	-0.11320754716981132
Thomas_Jefferson	wikicat_Democratic-Republican_Party_politicians	13350	14863	-1513	-0.11333333333333333
Rabat	wikicat_World_Heritage_Sites_in_Morocco	13365	14881	-1516	-0.1134306023194912
Terrel_Castle	wikicat_Makedonikos_B.C._players	14796	16480	-1684	-0.11381454447147878
Jeremy_Bentham	wikicat_LGBT_rights_activists_from_England	11723	13061	-1338	-0.11413460718246182
Matteo_Momentè	wikicat_Teramo_Calcio_players	14312	15960	-1648	-0.11514812744550028
Doris_Lessing	wikicat_21st-century_dramatists_and_playwrights	14311	15961	-1650	-0.11529592621060722
Michèle_Alliot-Marie	wikicat_Panthéon-Assas_University_alumni	129	144	-15	-0.11627906976744186
FK_Vojvodina	wikicat_Association_football_clubs_established_in_1914	94	105	-11	-0.11702127659574468
Felix_Ogbuke	wikicat_Enugu_Rangers_players	13260	14819	-1559	-0.11757164404223228
Central_Texas	wikicat_Great_Plains	10350	11567	-1217	-0.11758454106280193
Karl_Marx	wikicat_19th-century_economists	25	28	-3	-0.12
Praemium_Imperiale	wikicat_Architecture_awards	33	37	-4	-0.12121212121212122
Molot-Prikamye_Perm	wikicat_Sports_clubs_established_in_1948	12440	13959	-1519	-0.12210610932475885
Tórshavn	wikicat_Municipalities_of_the_Faroe_Islands	14801	16625	-1824	-0.12323491655969192
Charlie_Davies	wikicat_FC_Sochaux-Montbéliard_players	1371	1542	-171	-0.12472647702407003
Arne_Friedrich	wikicat_Germany_international_footballers	32	36	-4	-0.125
California	wikicat_States_of_the_United_States	8	9	-1	-0.125
Rod_Serling	wikicat_Writers_from_New_York	40	45	-5	-0.125
Walter_Novellino	wikicat_Italy_international_footballers	8	9	-1	-0.125
F.C._Hansa_Rostock	wikicat_Football_clubs_in_East_Germany	16	18	-2	-0.125
George_Best	wikicat_Expatriate_soccer_players_in_South_Africa	24	27	-3	-0.125
Helsinki	wikicat_Municipalities_of_Uusimaa	16	18	-2	-0.125
Lyn_Fotball	wikicat_Association_football_clubs_disestablished_in_2010	16	18	-2	-0.125
George_Best	wikicat_People_from_Belfast	8	9	-1	-0.125
Europe_Ecology_–_The_Greens	wikicat_Green_political_parties	8	9	-1	-0.125
Sunil_Dutt	wikicat_Indian_National_Congress_politicians	13605	15315	-1710	-0.1256890848952591
Jerusalem	wikicat_Amarna_letters_locations	158	178	-20	-0.12658227848101267
Ernest_Rutherford	wikicat_People_educated_at_Nelson_College	14113	15922	-1809	-0.1281796924821087
Estonia_national_football_team	wikicat_National_sports_teams_of_Estonia	14426	16286	-1860	-0.12893386940246776
Hugh_Grant	wikicat_People_from_Hammersmith_and_Fulham_(London_borough)	13761	15537	-1776	-0.1290603880531938
Anthony_Eden	wikicat_British_diplomats	14136	15967	-1831	-0.12952744765138652
New_Delhi	wikicat_Capitals	91	103	-12	-0.13186813186813187
Austin,_Texas	wikicat_Cities_in_Travis_County,_Texas	12441	14092	-1651	-0.13270637408568442
Masaru_Sato	wikicat_People_from_Hokkaido	15719	17806	-2087	-0.1327692601310516
Max_Planck	wikicat_20th-century_German_people	15	17	-2	-0.13333333333333333
Gaston_Doumergue	wikicat_French_people_of_World_War_I	15	17	-2	-0.13333333333333333
Jared_Borgetti	wikicat_2005_FIFA_Confederations_Cup_players	352	399	-47	-0.13352272727272727
Haile_Selassie_I_of_Ethiopia	wikicat_Chief_Commanders_of_the_Legion_of_Merit	15196	17232	-2036	-0.13398262700710714
Eduardo_Marques	wikicat_APOP_Kinyras_FC_players	234	266	-32	-0.13675213675213677
Amsterdam	wikicat_Port_cities_and_towns_in_the_Netherlands	14743	16762	-2019	-0.13694634741911416
50_Cent	wikicat_People_from_Jamaica,_Queens	11286	12837	-1551	-0.13742690058479531
Cook_County,_Illinois	wikicat_Populated_places_established_in_1831	14635	16657	-2022	-0.13816194055346773
Central_Federal_District	wikicat_Federal_districts_of_Russia	10433	11875	-1442	-0.13821527844340076
Richard_Garcia	wikicat_Melbourne_City_FC_players	14595	16627	-2032	-0.13922576224734498
Castries	wikicat_Populated_places_established_in_1650	15409	17555	-2146	-0.13926925822571223
Pierce_Brosnan	wikicat_Honorary_Officers_of_the_Order_of_the_British_Empire	13645	15557	-1912	-0.14012458776108463
Kilmarnock_F.C.	wikicat_Association_football_clubs_established_in_1869	9598	10946	-1348	-0.1404459262346322
Aníbal_Cavaco_Silva	wikicat_Alumni_of_the_University_of_York	14951	17067	-2116	-0.1415289947160725
John_Magnier	wikicat_Owners_of_Epsom_Derby_winners	15115	17263	-2148	-0.1421104862719153
Ross_Macdonald	wikicat_American_crime_fiction_writers	7	8	-1	-0.14285714285714285
Walt_Disney	wikicat_American_people_of_Irish_descent	7	8	-1	-0.14285714285714285
Liam_Neeson	wikicat_American_television_actors	7	8	-1	-0.14285714285714285
Kunming_Changshui_International_Airport	wikicat_Airports_established_in_2012	8705	9951	-1246	-0.14313612866168868
Lulu_(singer)	wikicat_Atco_Records_artists	286	327	-41	-0.14335664335664336
Eau_Claire,_Wisconsin	wikicat_Cities_in_Chippewa_County,_Wisconsin	12895	14746	-1851	-0.14354400930593253
J._R._Bremer	wikicat_CB_Málaga_players	125	143	-18	-0.144
Joe_Bradshaw_(footballer)	wikicat_Bristol_City_F.C._managers	208	238	-30	-0.14423076923076922
Melissa_Tancredi	wikicat_Saint_Louis_Athletica_players	12851	14735	-1884	-0.1466033771690919
Dino_Fava	wikicat_S.S._Formia_Calcio_players	12581	14431	-1850	-0.14704713456799937
Liverpool_F.C.	wikicat_G-14_clubs	34	39	-5	-0.14705882352941177
Maurice_Ross	wikicat_Motherwell_F.C._players	61	70	-9	-0.14754098360655737
Zurich_Airport	wordnet_airport_102692232	27	31	-4	-0.14814814814814814
Chien-Shiung_Wu	wikicat_Chinese_emigrants_to_the_United_States	489	562	-73	-0.1492842535787321
Robin_Cook_(American_novelist)	wikicat_Harvard_University_alumni	87	100	-13	-0.14942528735632185
Édison_Méndez	wikicat_People_from_Ibarra,_Ecuador	14418	16575	-2157	-0.1496046608406159
Frosinone_Calcio	wikicat_Association_football_clubs_established_in_1928	80	92	-12	-0.15
Apocalypse_Now	wikicat_Paramount_Pictures_films	60	69	-9	-0.15
Bruno_Rodriguez	wikicat_AC_Ajaccio_players	20	23	-3	-0.15
Hong_Kong	wikicat_Islands_of_China	13971	16077	-2106	-0.15074082027056046
Junior_Agogo	wikicat_Colorado_Rapids_players	33	38	-5	-0.15151515151515152
A.E.K._Athens_F.C.	wordnet_club_108227214	13	15	-2	-0.15384615384615385
William_Holden	wikicat_People_from_Illinois	26	30	-4	-0.15384615384615385
Diego_Bustamante	wikicat_FBC_Melgar_footballers	13310	15361	-2051	-0.1540946656649136
Mike_Myers	wikicat_Canadian_expatriate_male_actors_in_the_United_States	13687	15811	-2124	-0.1551837510046029
Gilbert_Bodart	wikicat_SC_Eendracht_Aalst_managers	12518	14483	-1965	-0.15697395750119827
Friedrich_Hayek	wikicat_Libertarian_historians	13327	15429	-2102	-0.15772491933668492
Nassim_Mendil	wikicat_Algerian_expatriates_in_Belgium	13684	15852	-2168	-0.1584332066647179
Caroline_Seger	wikicat_Western_New_York_Flash_players	25	29	-4	-0.16
Emrah_Eren	wikicat_Denizlispor_footballers	25	29	-4	-0.16
American_Revolutionary_War	wikicat_Wars_of_independence	56	65	-9	-0.16071428571428573
University_of_Bristol	wikicat_Organizations_established_in_1909	11098	12912	-1814	-0.1634528743917823
Lower_Austria	wikicat_Historical_regions_in_Austria	55	64	-9	-0.16363636363636364
George_Best	wikicat_Queensland_Lions_players	13898	16181	-2283	-0.16426824003453736
San_Francisco_Seals_(soccer)	wikicat_Soccer_clubs_in_San_Francisco,_California	11662	13585	-1923	-0.16489452924026754
Glen_Moss	wikicat_Expatriate_footballers_in_Romania	212	247	-35	-0.1650943396226415
Steven_Spielberg	wikicat_American_billionaires	15170	17675	-2505	-0.16512854317732367
South_Pyongan_Province	wikicat_Provinces_of_North_Korea	14309	16684	-2375	-0.16597945349080998
Mogilev_Region	wikicat_Regions_of_Belarus	6	7	-1	-0.16666666666666666
Kamloops_Blazers	wikicat_Sports_clubs_established_in_1981	1884	2198	-314	-0.16666666666666666
Robert_B._Parker	wikicat_21st-century_American_novelists	6	7	-1	-0.16666666666666666
Russian_Academy_of_Sciences	wikicat_Academic_institutions	6	7	-1	-0.16666666666666666
Real_Zaragoza	wikicat_Association_football_clubs_established_in_1932	30	35	-5	-0.16666666666666666
Media_General	wikicat_Media_companies_of_the_United_States	12	14	-2	-0.16666666666666666
Carrie_Fisher	wikicat_American_film_producers	6	7	-1	-0.16666666666666666
Phil_Keaggy	wikicat_American_composers	6	7	-1	-0.16666666666666666
Robert_B._Parker	wikicat_21st-century_American_writers	6	7	-1	-0.16666666666666666
Málaga	wikicat_University_towns	12	14	-2	-0.16666666666666666
Frances_Goodrich	wikicat_American_screenwriters	6	7	-1	-0.16666666666666666
Brooke_Shields	wikicat_American_female_models	6	7	-1	-0.16666666666666666
Georg_Wilhelm_Friedrich_Hegel	wikicat_18th-century_German_writers	6	7	-1	-0.16666666666666666
Tom_Stoppard	wikicat_21st-century_dramatists_and_playwrights	12502	14589	-2087	-0.16693329067349225
Joventut_Badalona	wikicat_Sports_clubs_established_in_1930	10711	12508	-1797	-0.16777144991130613
Kathy_Bates	wikicat_People_from_Memphis,_Tennessee	14440	16865	-2425	-0.16793628808864267
Tashkent	wikicat_Populated_places_in_Uzbekistan	11349	13270	-1921	-0.16926601462683938
Mircea_Rednic	wikicat_Romanian_expatriates_in_Azerbaijan	13113	15350	-2237	-0.17059406695645543
Émile_Mpenza	wikicat_People_from_Brussels	3144	3686	-542	-0.17239185750636132
Mansfield_Town_F.C.	wikicat_Football_clubs_in_Nottinghamshire	29	34	-5	-0.1724137931034483
J._Robert_Oppenheimer	wikicat_Nuclear_physicists	23	27	-4	-0.17391304347826086
Asrani	wikicat_Indian_comedians	23	27	-4	-0.17391304347826086
Johnny_Torres	wikicat_New_England_Revolution_players	40	47	-7	-0.175
Cristian_González_Aidinovich	wikicat_Liverpool_F.C._(Montevideo)_players	12896	15159	-2263	-0.17548076923076922
Guilherme_de_Cássio_Alves	wikicat_People_from_Marília	164	193	-29	-0.17682926829268292
Mos_Def	wikicat_People_from_Bedford–Stuyvesant,_Brooklyn	14595	17179	-2584	-0.17704693388146625
Rodney_Bush	wikicat_White_South_African_people	648	763	-115	-0.17746913580246915
Matt_Taylor_(footballer)	wikicat_Team_Bath_F.C._players	13301	15674	-2373	-0.1784076385234193
Oregon_State_University	wikicat_Educational_institutions_established_in_1868	28	33	-5	-0.17857142857142858
Dennis_Rodman	wikicat_Small_forwards	83	98	-15	-0.18072289156626506
Walter_Novellino	wikicat_A.C._Perugia_Calcio_managers	13822	16327	-2505	-0.18123281724786572
Nassim_Mendil	wikicat_A.C._Pro_Sesto_players	10901	12882	-1981	-0.1817264471149436
Winston_Churchill	wikicat_Knights_of_the_Garter	11	13	-2	-0.18181818181818182
Bury_F.C.	wikicat_Football_clubs_in_Bury	12239	14465	-2226	-0.18187760437944275
Bronisław_Komorowski	wikicat_Presidents_of_Poland	13190	15590	-2400	-0.1819560272934041
City_of_Carlisle	wikicat_Cities_in_North_West_England	82	97	-15	-0.18292682926829268
Pierre_Trudeau	wikicat_Université_de_Montréal_alumni	12925	15295	-2370	-0.18336557059961314
Gary_Alexander_(basketball)	wikicat_People_from_Jacksonville,_Florida	12923	15315	-2392	-0.18509633985916582
Thomas_Paine	wikicat_People_from_Greenwich_Village,_New_York	873	1035	-162	-0.18556701030927836
Bruce_Dickinson	wikicat_Singers_with_a_four-octave_vocal_range	1405	1668	-263	-0.18718861209964413
Lee_Chapman	wikicat_Swansea_City_A.F.C._players	37	44	-7	-0.1891891891891892
Granville,_Manche	wikicat_Spa_towns_in_France	12813	15247	-2434	-0.1899633185046437
Kung_Fu_Panda	wikicat_2000s_comedy_films	42	50	-8	-0.19047619047619047
Zell_am_See	wikicat_Cities_and_towns_in_Salzburg_(state)	88	105	-17	-0.19318181818181818
Sissy_Spacek	wikicat_Actors_Studio_alumni	2659	3173	-514	-0.19330575404287326
Carlos_Squeo	wikicat_Club_Atlético_Belgrano_footballers	31	37	-6	-0.1935483870967742
Paul_Baker	wikicat_Hartlepool_United_F.C._players	62	74	-12	-0.1935483870967742
Martin_Luther_King,_Jr.	wikicat_Morehouse_College_alumni	13308	15888	-2580	-0.19386834986474302
Corey_Feldman	wikicat_People_from_the_San_Fernando_Valley	14362	17157	-2795	-0.19461077844311378
Al-Taawon_FC	wikicat_Association_football_clubs_established_in_1956	1076	1286	-210	-0.19516728624535315
Nagasaki	wikicat_World_War_II_sites_in_Japan	14057	16842	-2785	-0.19812193213345664
CA_Bordj_Bou_Arréridj	wikicat_Association_football_clubs_established_in_1931	2603	3120	-517	-0.19861698040722245
Jared_Borgetti	wikicat_Bolton_Wanderers_F.C._players	566	679	-113	-0.19964664310954064
North_African_Campaign	wikicat_Battles_and_operations_of_World_War_II_involving_France	5	6	-1	-0.2
Dilip_Kumar	wikicat_Male_actors_from_Mumbai	5	6	-1	-0.2
Sissy_Spacek	wikicat_21st-century_American_actresses	5	6	-1	-0.2
George_MacDonald_Fraser	wikicat_British_journalists	35	42	-7	-0.2
Erasmus_Prize	wordnet_award_106696483	10	12	-2	-0.2
John_Badham	wikicat_British_people	5	6	-1	-0.2
Fausto_Lourenço	wikicat_Expatriate_footballers_in_Bulgaria	5	6	-1	-0.2
Miah_Dennehy	wikicat_Waterford_United_F.C._players	5	6	-1	-0.2
Jordi_Gómez	wikicat_FC_Barcelona_footballers	5	6	-1	-0.2
Jakarta	wikicat_Cities_with_millions_of_inhabitants	5	6	-1	-0.2
Anders_Jacobsen_(footballer)	wikicat_Skeid_Fotball_players	5	6	-1	-0.2
Darren_Mansaram	wikicat_York_City_F.C._players	40	48	-8	-0.2
Massachusetts_Institute_of_Technology	wikicat_Land-grant_universities_and_colleges	5	6	-1	-0.2
Walid_Atta	wikicat_Väsby_United_players	14431	17322	-2891	-0.2003326172822396
Pete_Seeger	wikicat_Artists_from_New_York	10786	12968	-2182	-0.2022992768403486
Bronze_Star_Medal	wikicat_Awards_and_decorations_of_the_United_States_Army	14119	17023	-2904	-0.2056802889723068
William_Golding	wikicat_Royal_Navy_sailors	925	1118	-193	-0.20864864864864865
Ian_McLagan	wikicat_People_from_Hounslow	11515	13935	-2420	-0.21016066000868433
David_Martin_(footballer_born_1986)	wikicat_Derby_County_F.C._players	19	23	-4	-0.21052631578947367
Camille_Abily	wikicat_Paris_Saint-Germain_F.C._(Ladies)_players	432	523	-91	-0.21064814814814814
Dennis_William_Sciama	wikicat_People_educated_at_Malvern_College	763	924	-161	-0.21100917431192662
Kent_O'Connor	wikicat_Association_football_defenders	90	109	-19	-0.2111111111111111
Lucille_Ball	wikicat_American_people_of_French_descent	33	40	-7	-0.21212121212121213
Terrance_Roberson	wikicat_BC_Kyiv_players	13167	15975	-2808	-0.21326042378673957
John_Ireland_(actor)	wikicat_American_people_of_Canadian_descent	14	17	-3	-0.21428571428571427
Rik_Mayall	wikicat_British_comedians	14	17	-3	-0.21428571428571427
United_States	wikicat_Member_states_of_NATO	14	17	-3	-0.21428571428571427
Mark_Williams_(Northern_Ireland_footballer)	wikicat_Stoke_City_F.C._players	56	68	-12	-0.21428571428571427
Saracens_F.C.	wikicat_Sports_clubs_established_in_1876	10890	13224	-2334	-0.2143250688705234
Kalusha_Bwalya	wikicat_Zambian_footballers	12871	15633	-2762	-0.2145909408748349
Locarno	wikicat_Populated_places_on_Lake_Maggiore	12299	14960	-2661	-0.216359053581592
Precious_Emuejeraye	wikicat_Nigerian_emigrants_to_Singapore	12840	15626	-2786	-0.21697819314641745
Vital_Lyadzyanyow	wikicat_FC_Gorodeya_players	9445	11511	-2066	-0.21874007411328744
Gabriel_Urdaneta	wikicat_SV_Waldhof_Mannheim_players	1295	1579	-284	-0.2193050193050193
Meryl_Streep	wikicat_American_atheists	41	50	-9	-0.21951219512195122
New_France	wikicat_Former_regions_and_territories_of_the_United_States	13290	16223	-2933	-0.22069224981188865
Las_Vegas	wikicat_County_seats_in_Nevada	10969	13399	-2430	-0.2215334123438782
Harvard_College	wikicat_Educational_institutions_established_in_the_17th_century	9559	11680	-2121	-0.22188513442828747
Navy_Cross	wikicat_Courage_awards	9	11	-2	-0.2222222222222222
Kozienice_County	wikicat_Land_counties_of_Masovian_Voivodeship	9	11	-2	-0.2222222222222222
Giulietta_Masina	wikicat_Actresses_from_Rome	12776	15635	-2859	-0.2237789605510332
Oleh_Taran	wikicat_Soviet_expatriate_footballers	12278	15028	-2750	-0.22397784655481348
Nozomi_Hiroyama	wikicat_Cerezo_Osaka_players	13678	16743	-3065	-0.22408246819710484
Karl_Marx	wikicat_Marxist_journalists	12686	15543	-2857	-0.22520889169162855
Reba_McEntire	wikicat_People_from_McAlester,_Oklahoma	222	272	-50	-0.22522522522522523
Rabiola	wikicat_Piast_Gliwice_players	1189	1458	-269	-0.22624053826745164
Greg_Strong	wikicat_Livingston_F.C._players	53	65	-12	-0.22641509433962265
Fredrik_Björck	wikicat_Tromsø_IL_players	612	751	-139	-0.22712418300653595
Andrey_Movsisyan	wikicat_FC_Saturn_Ramenskoye_players	22	27	-5	-0.22727272727272727
FC_St._Pauli	wikicat_Women's_association_football_clubs	57	70	-13	-0.22807017543859648
Peter_Frampton	wikicat_Lead_guitarists	13	16	-3	-0.23076923076923078
George_Parris	wikicat_Bristol_City_F.C._players	52	64	-12	-0.23076923076923078
Roger_Glover	wikicat_British_bass_guitarists	26	32	-6	-0.23076923076923078
Alexander_Graham_Bell	wikicat_American_people_of_Scottish_descent	117	144	-27	-0.23076923076923078
Eric_Clapton	wikicat_Warner_Bros._Records_artists	810	997	-187	-0.2308641975308642
Matteo_Momentè	wikicat_Calcio_Montebelluna_players	13704	16879	-3175	-0.23168417980151781
North_Carolina	wikicat_States_and_territories_established_in_1789	11894	14653	-2759	-0.23196569699007902
Rincón_(footballer_born_1987)	wikicat_Empoli_F.C._players	458	566	-108	-0.23580786026200873
Mato_Neretljak	wikicat_People_from_Orašje	12457	15400	-2943	-0.236252709320061
Roger_Glover	wikicat_Rock_bass_guitarists	55	68	-13	-0.23636363636363636
Davos	wikicat_Ski_areas_and_resorts_in_Switzerland	13556	16769	-3213	-0.23701681912068456
Gustavo_Reggi	wikicat_Unión_de_Santa_Fe_footballers	270	334	-64	-0.23703703703703705
Anthony_Eden	wikicat_Earls_in_the_Peerage_of_the_United_Kingdom	13636	16879	-3243	-0.23782634203578762
University_of_San_Francisco	wikicat_Roman_Catholic_schools_in_the_United_States	11863	14702	-2839	-0.23931551884009103
Cuca_(footballer)	wikicat_People_from_Curitiba	13045	16172	-3127	-0.23970870065159064
Judith_Butler	wikicat_Jewish_writers	25	31	-6	-0.24
Deportivo_Pereira	wikicat_Football_clubs_in_Colombia	295	366	-71	-0.24067796610169492
Niels_Bohr	wikicat_Physical_chemists	199	247	-48	-0.24120603015075376
Sergio_Volpi	wikicat_Brescia_Calcio_players	29	36	-7	-0.2413793103448276
Klaus_Toppmöller	wikicat_FC_Erzgebirge_Aue_managers	12300	15272	-2972	-0.2416260162601626
Jerry_Pournelle	wikicat_American_bloggers	119	148	-29	-0.24369747899159663
Sivaji_Ganesan	wikicat_People_from_Thanjavur_district	435	542	-107	-0.24597701149425288
Valdas_Ivanauskas	wikicat_Lithuanian_football_managers	251	313	-62	-0.24701195219123506
Mia_Farrow	wikicat_UNICEF_people	464	579	-115	-0.2478448275862069
Toshiko_Akiyoshi	wikicat_American_jazz_pianists	4	5	-1	-0.25
Edmund_Gwenn	wikicat_People_from_Wandsworth_(London_borough)	12	15	-3	-0.25
Maldives	wikicat_Member_states_of_the_South_Asian_Association_for_Regional_Cooperation	4	5	-1	-0.25
Amartya_Sen	wikicat_Academics_of_the_London_School_of_Economics	136	170	-34	-0.25
Democratic_Action_Party	wikicat_Political_parties	64	80	-16	-0.25
Sérgio_Araújo	wikicat_Avaí_Futebol_Clube_players	56	70	-14	-0.25
Miloš_Kolaković	wikicat_Association_football_forwards	4	5	-1	-0.25
Carlos_Alberto_de_Jesus	wikicat_Campeonato_Brasileiro_Série_B_footballers	48	60	-12	-0.25
Alan_Dodd_(English_footballer)	wikicat_Landskrona_BoIS_players	36	45	-9	-0.25
Asturias_Airport	wordnet_airport_102692232	4	5	-1	-0.25
Georg_Wilhelm_Friedrich_Hegel	wikicat_Philosophers_of_art	4	5	-1	-0.25
Richland_County,_South_Carolina	wordnet_county_108546183	4	5	-1	-0.25
Piacenza_Calcio	wikicat_Association_football_clubs_established_in_1919	24	30	-6	-0.25
War_of_the_Second_Coalition	wikicat_Napoleonic_Wars_treaties	12	15	-3	-0.25
David_Cassidy	wikicat_American_television_actors	4	5	-1	-0.25
Evgeny_Yarovenko	wikicat_FC_Taraz_players	4	5	-1	-0.25
UE_Lleida	wikicat_Defunct_football_clubs_in_Spain	20	25	-5	-0.25
Cambridge,_Massachusetts	wikicat_Cities_in_Middlesex_County,_Massachusetts	4	5	-1	-0.25
Bloemfontein	wikicat_Populated_places_founded_by_Afrikaners	4	5	-1	-0.25
Laptev_Sea	wikicat_Seas_of_Russia	8	10	-2	-0.25
Dan_Aykroyd	wikicat_Carleton_University_alumni	8	10	-2	-0.25
Boz_Scaggs	wikicat_Guitarists	8	10	-2	-0.25
George_R._R._Martin	wikicat_American_people_of_English_descent	4	5	-1	-0.25
Lucero_(entertainer)	wikicat_Mexican_female_singers	4	5	-1	-0.25
Friedrich_Hirzebruch	wikicat_German_mathematicians	4	5	-1	-0.25
Junior_Agogo	wikicat_People_from_Accra	4	5	-1	-0.25
Tarlan_Ahmadov	wikicat_Azerbaijani_expatriate_footballers	4	5	-1	-0.25
Ricardo_Montalbán	wikicat_Dames_of_St._Gregory_the_Great	3392	4243	-851	-0.2508844339622642
Adam_Rooney	wikicat_Yeovil_Town_F.C._players	71	89	-18	-0.2535211267605634
Jared_Borgetti	wikicat_Mexican_people_of_Italian_descent	12630	15843	-3213	-0.2543942992874109
Joel_Soto	wikicat_San_Luis_de_Quillota_footballers	51	64	-13	-0.2549019607843137
Daniel_Dennett	wikicat_20th-century_American_people	2656	3347	-691	-0.2601656626506024
Riga_Mustapha	wikicat_Dutch_people_of_Ghanaian_descent	11909	15059	-3150	-0.2645058359224116
Jokerit	wikicat_Kontinental_Hockey_League_expansion_teams	11567	14635	-3068	-0.26523731304573356
Alexandre_Gallo	wikicat_São_Paulo_FC_players	41	52	-11	-0.2682926829268293
Miloš_Dimitrijević	wikicat_FC_Nantes_players	48	61	-13	-0.2708333333333333
Robert_Altman	wikicat_Film_directors_from_Missouri	654	832	-178	-0.27217125382262997
Michael_Duberry	wikicat_Association_football_defenders	33	42	-9	-0.2727272727272727
Robert_Jarni	wikicat_HNK_Hajduk_Split_players	11	14	-3	-0.2727272727272727
1._FC_Magdeburg	wikicat_Football_clubs_in_Saxony-Anhalt	11	14	-3	-0.2727272727272727
Dundee	wordnet_site_108651247	11	14	-3	-0.2727272727272727
Gustavo_Victoria	wikicat_Deportivo_Pereira_footballers	11	14	-3	-0.2727272727272727
Scary_Movie_4	wikicat_2006_films	117	149	-32	-0.27350427350427353
Technion_–_Israel_Institute_of_Technology	wikicat_Research_institutes_in_Israel	11338	14444	-3106	-0.27394602222614217
Alfred_North_Whitehead	wikicat_English_mathematicians	146	186	-40	-0.273972602739726
Søren_Larsen	wikicat_Brøndby_IF_players	51	65	-14	-0.27450980392156865
Krunoslav_Lovrek	wikicat_Cerezo_Osaka_players	12583	16065	-3482	-0.2767225621870778
Syracuse,_New_York	wikicat_Populated_places_on_the_Underground_Railroad	36	46	-10	-0.2777777777777778
Graham_Stack_(footballer)	wikicat_Leeds_United_A.F.C._players	161	206	-45	-0.2795031055900621
Fernando_Meira	wikicat_Portuguese_people	75	96	-21	-0.28
Stephen_Fry	wikicat_LGBT_directors	3600	4608	-1008	-0.28
Lassen_County,_California	wikicat_Populated_places_established_in_1864	11244	14407	-3163	-0.2813055852009961
Nicollette_Sheridan	wikicat_English_soap_opera_actresses	13734	17608	-3874	-0.2820736857434105
Kosovo_War	wikicat_Wars_involving_Serbia	11831	15198	-3367	-0.2845913278674668
Barack_Obama	wikicat_American_people_of_Huguenot_descent	256	329	-73	-0.28515625
Marius_Niculae	wikicat_Expatriate_footballers_in_Ukraine	7	9	-2	-0.2857142857142857
Jonathan_Gould	wikicat_Bradford_City_A.F.C._players	56	72	-16	-0.2857142857142857
Belo_Horizonte	wikicat_Populated_places_established_in_1701	3429	4412	-983	-0.2866724992709245
Samir_Aliyev	wikicat_Association_football_forwards	146	188	-42	-0.2876712328767123
Polonia_Warsaw	wikicat_Chess_clubs	190	245	-55	-0.2894736842105263
Monica_(singer)	wikicat_American_hip_hop_singers	17	22	-5	-0.29411764705882354
Jeremy_Bentham	wikicat_British_lawyers	5518	7152	-1634	-0.2961217832548025
Aristotle	wikicat_Virtue_ethicists	13257	17185	-3928	-0.2962962962962963
Moncef_Ouichaoui	wikicat_CA_Bordj_Bou_Arreridj_players	27	35	-8	-0.2962962962962963
Matteo_Momentè	wikicat_People_from_the_Province_of_Venice	12909	16750	-3841	-0.2975443489038655
Mateus_Galiano_da_Costa	wikicat_Angolan_expatriates_in_Portugal	11132	14453	-3321	-0.2983291412145167
Aleksandar_Komadina	wikicat_FC_Zimbru_Chișinău_players	11785	15309	-3524	-0.2990241832838354
Allen_Ginsberg	wikicat_Golden_Wreath_laureates	3480	4523	-1043	-0.2997126436781609
Chennai	wikicat_Cities_and_towns_in_Tamil_Nadu	10	13	-3	-0.3
Prix_Médicis	wikicat_Non-fiction_literary_awards	11117	14460	-3343	-0.3007106233696141
Adán_Vergara	wikicat_Universidad_Católica_footballers	106	138	-32	-0.3018867924528302
Clube_Atlético_Mineiro	wikicat_Football_clubs_in_Belo_Horizonte	11495	14975	-3480	-0.30274032187907784
John_Henry_Newman	wikicat_English_sermon_writers	9508	12405	-2897	-0.30469078670593186
İbrahim_Aydemir	wikicat_Etimesgut_Şekerspor_footballers	11127	14543	-3416	-0.3070009885863216
Oleg_Veretennikov	wikicat_FC_SKA_Rostov_players	10213	13349	-3136	-0.30705962988348184
Newark,_New_Jersey	wikicat_Populated_places_established_in_1666	9342	12213	-2871	-0.30732177263969174
Teri_Hatcher	wikicat_21st-century_actors	13	17	-4	-0.3076923076923077
Quentin_Tarantino	wikicat_German-language_film_directors	113	148	-35	-0.30973451327433627
Shimon_Peres	wikicat_Prime_Ministers_of_Israel	13060	17141	-4081	-0.3124808575803982
Marcus_Miller	wikicat_Fiorello_H._LaGuardia_High_School_alumni	7110	9343	-2233	-0.3140646976090014
Stephen_Hawking	wikicat_Commanders_of_the_Order_of_the_British_Empire	38	50	-12	-0.3157894736842105
Montgomery_Clift	wikicat_American_people_of_Scottish_descent	38	50	-12	-0.3157894736842105
Alexandre_Lopes	wikicat_Criciúma_Esporte_Clube_players	155	204	-49	-0.3161290322580645
Ivan_Dragičević	wikicat_FK_Banat_Zrenjanin_players	117	154	-37	-0.3162393162393162
Brampton	wikicat_Populated_places_in_Ontario	41	54	-13	-0.3170731707317073
Socialist_Federal_Republic_of_Yugoslavia	wikicat_States_and_territories_established_in_1945	9370	12345	-2975	-0.31750266808964783
Ville-Marie,_Montreal	wikicat_Boroughs_of_Montreal	11684	15399	-3715	-0.31795617939061965
Kitchee_SC	wikicat_Association_football_clubs_established_in_1931	5189	6845	-1656	-0.3191366351898246
Joyce_Carol_Oates	wikicat_Syracuse_University_alumni	11527	15219	-3692	-0.3202914895462826
Charles_de_Gaulle	wikicat_People_from_Lille	10885	14375	-3490	-0.3206247129076711
Debbie_Reynolds	wikicat_People_from_Beverly_Hills,_California	134	177	-43	-0.3208955223880597
Atila_Turan	wikicat_Turkish_expatriate_footballers	28	37	-9	-0.32142857142857145
Allentown,_Pennsylvania	wikicat_Populated_places_on_the_Lehigh_River	12353	16334	-3981	-0.32226989395288597
David_Martin_(footballer_born_1986)	wikicat_England_youth_international_footballers	65	86	-21	-0.3230769230769231
Adolf_Hitler	wikicat_World_War_II_political_leaders	37	49	-12	-0.32432432432432434
Imperia	wikicat_Cities_and_towns_in_Liguria	114	151	-37	-0.32456140350877194
Manuel_Márquez_de_León_International_Airport	wikicat_Airports_in_Baja_California_Sur	137	182	-45	-0.3284671532846715
Taiyuan	wikicat_Cities_in_Shanxi	10289	13703	-3414	-0.3318106715910195
Fábio_Bilica	wikicat_Olympic_footballers_of_Brazil	443	590	-147	-0.33182844243792325
Margaret_Sullavan	wikicat_American_stage_actors	3	4	-1	-0.3333333333333333
Gary_Forrester	wikicat_American_bluegrass_musicians	3	4	-1	-0.3333333333333333
Paramaribo	wordnet_site_108651247	6	8	-2	-0.3333333333333333
Havana	wikicat_Capitals_in_North_America	3	4	-1	-0.3333333333333333
Botswana	wikicat_States_and_territories_established_in_1975	12	16	-4	-0.3333333333333333
O._P._Nayyar	wordnet_person_100007846	27	36	-9	-0.3333333333333333
Graham_Arnold	wikicat_Expatriate_footballers_in_Japan	3	4	-1	-0.3333333333333333
Lin_Carter	wikicat_Fantasy_writers	12	16	-4	-0.3333333333333333
Charlie_McGillivray	wikicat_Motherwell_F.C._players	45	60	-15	-0.3333333333333333
Evgeny_Yarovenko	wikicat_Ukrainian_Premier_League_players	3	4	-1	-0.3333333333333333
Sérgio_Araújo	wikicat_Fluminense_Football_Club_players	3	4	-1	-0.3333333333333333
Velletri	wikicat_Cities_and_towns_in_Italy	3	4	-1	-0.3333333333333333
Cotonou	wikicat_Populated_places_in_Benin	3	4	-1	-0.3333333333333333
Vijay_(actor)	wikicat_Tamil_people	12	16	-4	-0.3333333333333333
Aldous_Huxley	wikicat_English_humanists	3	4	-1	-0.3333333333333333
Mińsk_County	wikicat_Land_counties_of_Masovian_Voivodeship	9	12	-3	-0.3333333333333333
Aldous_Huxley	wikicat_Science_fiction_writers	3	4	-1	-0.3333333333333333
Summit,_New_Jersey	wikicat_Cities_in_Union_County,_New_Jersey	9	12	-3	-0.3333333333333333
Wim_Suurbier	wikicat_Expatriate_soccer_players_in_the_United_States	9	12	-3	-0.3333333333333333
University_of_New_Mexico	wikicat_Oak_Ridge_Associated_Universities	3	4	-1	-0.3333333333333333
War_of_the_Second_Coalition	wikicat_19th-century_conflicts	3	4	-1	-0.3333333333333333
Kurt_Vonnegut	wikicat_Science_fiction_writers	3	4	-1	-0.3333333333333333
Nicolas_Anelka	wikicat_Shanghai_Shenhua_F.C._players	3	4	-1	-0.3333333333333333
Meera_Jasmine	wordnet_person_100007846	3	4	-1	-0.3333333333333333
Eric_Clapton	wikicat_English-language_singers	3	4	-1	-0.3333333333333333
Raul_Águas	wikicat_Association_football_forwards	12	16	-4	-0.3333333333333333
Karl_Marx	wikicat_Philosophers_of_law	9	12	-3	-0.3333333333333333
Le_Havre	wikicat_Ports_and_harbours_of_the_English_Channel	9	12	-3	-0.3333333333333333
Figari_Sud-Corse_Airport	wikicat_Airports_in_France	3	4	-1	-0.3333333333333333
Abdel_Sattar_Sabry	wikicat_C.S._Marítimo_players	9	12	-3	-0.3333333333333333
All_Boys	wordnet_club_108227214	9	12	-3	-0.3333333333333333
Roy_Scheider	wikicat_American_people_of_Irish_descent	3	4	-1	-0.3333333333333333
Ger_Rowe	wikicat_Dundalk_F.C._players	3	4	-1	-0.3333333333333333
David_Cassidy	wikicat_American_singers	3	4	-1	-0.3333333333333333
Philip_III_of_France	wikicat_Roman_Catholic_monarchs	3	4	-1	-0.3333333333333333
Cat_Power	wikicat_Pianists	137	183	-46	-0.3357664233576642
New_Bedford,_Massachusetts	wikicat_Cities_in_Bristol_County,_Massachusetts	12060	16119	-4059	-0.3365671641791045
Richard_O'Donnell	wikicat_Stockport_County_F.C._players	62	83	-21	-0.3387096774193548
50_Cent	wikicat_American_stock_traders	11893	15935	-4042	-0.33986378541999496
Andy_Williams_(Jamaican_footballer)	wikicat_Real_Salt_Lake_players	11779	15813	-4034	-0.3424738942185245
Anambra_State	wikicat_States_and_territories_established_in_1991	35	47	-12	-0.34285714285714286
Montpellier_HSC_(Ladies)	wikicat_Women's_football_clubs_in_France	10630	14280	-3650	-0.3433678269049859
Cédric_Roussel	wikicat_Wolverhampton_Wanderers_F.C._players	29	39	-10	-0.3448275862068966
Jim_Adams_(soccer)	wikicat_Cincinnati_Riverhawks_players	12233	16457	-4224	-0.3452955121392953
George_Carlin	wikicat_American_social_commentators	286	385	-99	-0.34615384615384615
Roger_Penrose	wikicat_Professors_of_Gresham_College	112	151	-39	-0.3482142857142857
Edward_Witten	wikicat_Fellows_of_the_American_Mathematical_Society	20	27	-7	-0.35
Barry_Manilow	wikicat_American_film_producers	20	27	-7	-0.35
Ronald_Arana	wikicat_Municipal_Real_Mamoré_players	12286	16637	-4351	-0.35414292690867655
Alekos_Alekou	wikicat_Cyprus_international_footballers	11764	15931	-4167	-0.3542162529751785
Michèle_Alliot-Marie	wikicat_Ministers_for_children,_young_people_and_families	12778	17327	-4549	-0.356002504304273
Mort_Shuman	wikicat_Jewish_American_musicians	42	57	-15	-0.35714285714285715
Jane_Wyman	wikicat_American_soap_opera_actresses	53	72	-19	-0.3584905660377358
Delta_Goodrem	wikicat_Actresses_from_Sydney	11876	16140	-4264	-0.35904344897271806
Pierre_Teilhard_de_Chardin	wikicat_Cosmologists	757	1029	-272	-0.35931307793923384
The_Hague	wikicat_Cities_in_Europe	11	15	-4	-0.36363636363636365
Justus_von_Liebig	wikicat_German_chemists	11	15	-4	-0.36363636363636365
Valentyn_Slyusar	wikicat_Ukrainian_football_managers	19	26	-7	-0.3684210526315789
Benjamin_Fondane	wikicat_Romanian_short_story_writers	73	100	-27	-0.3698630136986301
Fábio_Bilica	wikicat_F.B.C._Unione_Venezia_players	197	270	-73	-0.37055837563451777
Phil_Keaggy	wikicat_Musicians_from_Tennessee	12310	16875	-4565	-0.37083671811535335
Darío_Flores	wikicat_CD_Palestino_players	62	85	-23	-0.3709677419354839
Ontario_Liberal_Party	wikicat_Provincial_political_parties_in_Ontario	9757	13396	-3639	-0.3729630009224147
Tonnerre_Yaoundé	wikicat_Association_football_clubs_established_in_1934	1240	1705	-465	-0.375
Gene_Kelly	wikicat_American_people_of_Irish_descent	8	11	-3	-0.375
Gimnàstic_de_Tarragona	wikicat_Football_clubs_in_Catalonia	9179	12655	-3476	-0.3786904891600392
The_Lion_King	wikicat_Films_about_apes	29	40	-11	-0.3793103448275862
Bristol	wikicat_Local_government_districts_of_South_West_England	21	29	-8	-0.38095238095238093
Buckethead	wikicat_American_people	5624	7780	-2156	-0.3833570412517781
Matthew_Bellamy	wikicat_English_composers	13	18	-5	-0.38461538461538464
Danny_Califf	wikicat_Footballers_at_the_2000_Summer_Olympics	70	97	-27	-0.38571428571428573
Kang_Chul	wikicat_Sangmu_FC_(Semi-professional)_players	11134	15433	-4299	-0.38611460391593316
Takasaki,_Gunma	wikicat_Cities_in_Gunma_Prefecture	10914	15131	-4217	-0.38638446032618656
Nkana_F.C.	wikicat_Football_clubs_in_Zambia	10245	14206	-3961	-0.3866276232308443
Roberto_Pompei	wikicat_Huracán_managers	9873	13702	-3829	-0.3878253823559202
Robert_Robinson_(organic_chemist)	wikicat_Organic_chemists	7605	10556	-2951	-0.38803418803418804
Džoni_Novak	wikicat_FK_Partizan_players	142	198	-56	-0.39436619718309857
Yale_Law_School	wikicat_Educational_institutions_established_in_1824	9319	13001	-3682	-0.39510677111278036
Neil_Lennon	wikicat_Northern_Ireland_B_international_footballers	358	500	-142	-0.39664804469273746
Namibian_War_of_Independence	wikicat_Wars_of_independence	10	14	-4	-0.4
Michael_Lamey	wikicat_Dutch_footballers	5	7	-2	-0.4
Aníbal_Cavaco_Silva	wikicat_Knights_of_the_Order_of_the_Gold_Lion_of_the_House_of_Nassau	5	7	-2	-0.4
Order_of_the_Nile	wordnet_award_106696483	5	7	-2	-0.4
Jean-Luc_Godard	wikicat_Writers_from_Paris	35	49	-14	-0.4
Frances_Goodrich	wikicat_Writers	5	7	-2	-0.4
Peter_Kropotkin	wikicat_Russian_expatriates	5	7	-2	-0.4
Dick_Van_Dyke	wikicat_21st-century_American_singers	15	21	-6	-0.4
Duluth,_Georgia	wikicat_Populated_places_in_Georgia_(U.S._state)	5	7	-2	-0.4
Elazığ_Province	wordnet_administrative_district_108491826	5	7	-2	-0.4
Gottlob_Frege	wikicat_20th-century_mathematicians	5	7	-2	-0.4
War_of_the_Second_Coalition	wikicat_18th-century_conflicts	5	7	-2	-0.4
William_Thomson,_1st_Baron_Kelvin	wikicat_People_of_the_Industrial_Revolution	5	7	-2	-0.4
Frank_Sinatra	wikicat_Western_(genre)_film_actors	5	7	-2	-0.4
George_Carlin	wikicat_Actors_from_New_York	5	7	-2	-0.4
Bruce_Greenwood	wikicat_Canadian_male_voice_actors	5	7	-2	-0.4
Joe_Addo	wikicat_VfB_Stuttgart_II_players	935	1313	-378	-0.4042780748663102
Barry_Manilow	wikicat_Juilliard_School_alumni	679	956	-277	-0.40795287187039764
Jean_Harlow	wikicat_Actresses_from_Los_Angeles,_California	49	69	-20	-0.40816326530612246
Juan_Carlos_Reyes_(footballer)	wikicat_Juventud_Independiente_footballers	93	131	-38	-0.40860215053763443
Alessio_Cerci	wikicat_2014_FIFA_World_Cup_players	44	62	-18	-0.4090909090909091
Anne,_Princess_Royal	wikicat_Living_people	171	241	-70	-0.4093567251461988
Shimon_Peres	wikicat_Hebrew-language_writers	10913	15386	-4473	-0.40987812700449006
Dennis_William_Sciama	wikicat_People_from_Manchester	39	55	-16	-0.41025641025641024
Jackass_Number_Two	wikicat_2006_films	173	244	-71	-0.41040462427745666
Carlos_María_Morales	wikicat_LDU_Quito_footballers	190	268	-78	-0.4105263157894737
Henri_Lefebvre	wikicat_Marxist_humanists	297	419	-122	-0.4107744107744108
José_Javier_Barkero	wikicat_CD_Numancia_players	73	103	-30	-0.410958904109589
Talia_Shire	wikicat_People_from_Long_Island	51	72	-21	-0.4117647058823529
Luton	wikicat_Towns_in_Bedfordshire	126	178	-52	-0.4126984126984127
James_Wong_(lyricist)	wikicat_Hong_Kong_male_singers	9441	13368	-3927	-0.4159517000317763
Charles_Scott_Sherrington	wikicat_Fellows_of_Magdalen_College,_Oxford	24	34	-10	-0.4166666666666667
50_Cent	wikicat_American_hip_hop_record_producers	12	17	-5	-0.4166666666666667
Kelly_Berville	wikicat_APOP_Kinyras_FC_players	237	336	-99	-0.4177215189873418
University_of_Victoria	wikicat_Educational_institutions_established_in_1903	9431	13387	-3956	-0.4194677128618386
Precious_Emuejeraye	wikicat_Singaporean_expatriate_footballers	9159	13003	-3844	-0.4196964734141282
Barry_Manilow	wikicat_People_from_Brooklyn	19	27	-8	-0.42105263157894735
Frédéric_Nimani	wikicat_France_under-21_international_footballers	19	27	-8	-0.42105263157894735
Sherman_Oaks,_Los_Angeles	wikicat_Los_Angeles_County,_California_regions	9827	14016	-4189	-0.4262745497099827
Darragh_Ryan	wikicat_St_Patrick's_Athletic_F.C._players	7	10	-3	-0.42857142857142855
Bernardo_Tengarrinha	wikicat_PFC_CSKA_Sofia_players	7	10	-3	-0.42857142857142855
Atila_Turan	wikicat_French_expatriate_footballers	7	10	-3	-0.42857142857142855
Frank_Tuttle	wikicat_Screenwriters	7	10	-3	-0.42857142857142855
Whig_Party_(United_States)	wikicat_Defunct_political_parties_in_the_United_States	7	10	-3	-0.42857142857142855
Cairo	wikicat_Cities_in_Egypt	7	10	-3	-0.42857142857142855
Plovdiv	wikicat_Former_capitals_of_Bulgaria	7	10	-3	-0.42857142857142855
L'Entente_SSG	wikicat_Association_football_clubs_established_in_1989	3297	4712	-1415	-0.4291780406430088
Aurelio_Vidmar	wikicat_People_from_Adelaide	1454	2081	-627	-0.4312242090784044
Dorinel_Munteanu	wikicat_People_from_Caraș-Severin_County	11482	16459	-4977	-0.4334610695000871
Toshiko_Akiyoshi	wikicat_Japanese_people_from_Manchukuo	11670	16773	-5103	-0.4372750642673522
Daryl_Taylor	wikicat_Hinckley_United_F.C._players	16	23	-7	-0.4375
Mao_Zedong	wikicat_Political_philosophers	16	23	-7	-0.4375
Kalusha_Bwalya	wikicat_Correcaminos_UAT_footballers	50	72	-22	-0.44
Charles_K._Kao	wikicat_Japan_Prize_laureates	72	104	-32	-0.4444444444444444
Chandigarh	wikicat_Planned_cities	126	182	-56	-0.4444444444444444
Tom_Skerritt	wikicat_American_male_actors	9	13	-4	-0.4444444444444444
Matthew_Bellamy	wikicat_British_libertarians	2264	3278	-1014	-0.44787985865724383
Murray_Gell-Mann	wikicat_Particle_physicists	40	58	-18	-0.45
Brasília	wordnet_site_108651247	20	29	-9	-0.45
Buckethead	wikicat_Progressive_metal_guitarists	20	29	-9	-0.45
Inglourious_Basterds	wikicat_German_films	8645	12563	-3918	-0.45320994794679004
Athens	wikicat_Biblical_places	22	32	-10	-0.45454545454545453
Epirus	wikicat_Provinces_of_Greece	11	16	-5	-0.45454545454545453
Gary_Alexander_(basketball)	wikicat_Cleveland_Cavaliers_players	11	16	-5	-0.45454545454545453
Mia_Farrow	wikicat_Stage_actors	11	16	-5	-0.45454545454545453
Giovanny_Espinoza	wikicat_C.F._Monterrey_footballers	288	419	-131	-0.4548611111111111
Kim_Christensen_(footballer_born_1980)	wikicat_FC_Twente_players	180	262	-82	-0.45555555555555555
Alicia_Silverstone	wikicat_American_people_of_British-Jewish_descent	46	67	-21	-0.45652173913043476
Simon_Grand	wikicat_Association_football_defenders	24	35	-11	-0.4583333333333333
Fellipe_Bastos	wikicat_Campeonato_Brasileiro_Série_B_footballers	50	73	-23	-0.46
Tokat	wikicat_Provinces_of_Turkey	26	38	-12	-0.46153846153846156
FC_Slovan_Liberec	wikicat_Association_football_clubs_established_in_1921	39	57	-18	-0.46153846153846156
Geno_Carlisle	wikicat_People_from_Grand_Rapids,_Michigan	7220	10557	-3337	-0.46218836565096955
FC_Ripensia_Timișoara	wikicat_Association_football_clubs_established_in_1928	121	177	-56	-0.4628099173553719
Friedrich_Engels	wikicat_People_from_the_Rhine_Province	172	252	-80	-0.46511627906976744
Greta_Scacchi	wikicat_Australian_people	15	22	-7	-0.4666666666666667
Joyce_Carol_Oates	wikicat_American_poets	60	88	-28	-0.4666666666666667
Scott_Willis_(footballer)	wikicat_Stalybridge_Celtic_F.C._players	94	138	-44	-0.46808510638297873
L.A._Reid	wikicat_Reality_television_judges	740	1087	-347	-0.4689189189189189
Mounir_El_Hamdaoui	wikicat_AFC_Ajax_players	53	78	-25	-0.4716981132075472
Rincón_(footballer_born_1987)	wikicat_Inter_Milan_players	131	193	-62	-0.4732824427480916
C.S._Marítimo	wikicat_Association_football_clubs_established_in_1910	19	28	-9	-0.47368421052631576
Georg_Wilhelm_Friedrich_Hegel	wikicat_Architectural_theoreticians	229	338	-109	-0.4759825327510917
Steven_Tyler	wikicat_American_heavy_metal_singers	21	31	-10	-0.47619047619047616
Newport_RFC	wikicat_Welsh_rugby_union_teams	10777	15921	-5144	-0.47731279576876684
The_Specials	wikicat_British_reggae_musical_groups	10361	15338	-4977	-0.4803590387028279
Silkeborg	wordnet_administrative_district_108491826	243	360	-117	-0.48148148148148145
Roger_Ebert	wikicat_Science_fiction_fans	134	199	-65	-0.48507462686567165
Captain_Beefheart	wikicat_Harmonica_players	1535	2280	-745	-0.48534201954397393
Empoli_F.C.	wikicat_Association_football_clubs_established_in_1920	37	55	-18	-0.4864864864864865
Nick_Cave	wikicat_Alternative_rock_musicians	630	937	-307	-0.4873015873015873
Branco_(footballer)	wikicat_1986_FIFA_World_Cup_players	157	234	-77	-0.49044585987261147
Gustavo_Reggi	wikicat_Reggina_Calcio_players	110	164	-54	-0.4909090909090909
Dario_Dabac	wikicat_Association_football_fullbacks	352	525	-173	-0.4914772727272727
Norm_Macdonald	wikicat_Writers	774	1159	-385	-0.4974160206718346
Tours_FC	wordnet_club_108227214	2	3	-1	-0.5
George_Carlin	wikicat_20th-century_American_actors	2	3	-1	-0.5
Immanuel_Kant	wikicat_German_philosophers	2	3	-1	-0.5
Macau	wikicat_Port_cities_and_towns_in_China	10	15	-5	-0.5
Henry_Jaglom	wikicat_Film_directors_from_London	10	15	-5	-0.5
Vijay_(actor)	wikicat_Tamil_actors	2	3	-1	-0.5
Milan_Stojanoski	wikicat_Macedonian_footballers	2	3	-1	-0.5
Kemi	wikicat_Port_cities_and_towns_in_Finland	2	3	-1	-0.5
Danny_Graham_(footballer)	wikicat_Sunderland_A.F.C._players	12	18	-6	-0.5
Kostyantyn_Panin	wikicat_Ukrainian_footballers	4	6	-2	-0.5
Ricardo_Sousa	wikicat_Expatriate_footballers_in_the_Netherlands	2	3	-1	-0.5
Brian_Clemens	wikicat_English_screenwriters	2	3	-1	-0.5
Émile_Durkheim	wikicat_19th-century_philosophers	14	21	-7	-0.5
Bismarck,_North_Dakota	wikicat_Cities_in_North_Dakota	2	3	-1	-0.5
Socialist_Party_(Portugal)	wikicat_Political_parties_in_Portugal	12	18	-6	-0.5
Barnet	wordnet_site_108651247	2	3	-1	-0.5
C.D._Universidad_de_Concepción	wordnet_club_108227214	2	3	-1	-0.5
Norman_Foster_(director)	wikicat_American_film_directors	2	3	-1	-0.5
John_Stuart_Mill	wikicat_Atheist_philosophers	8	12	-4	-0.5
Rivaldo_Barbosa_de_Souza	wikicat_Sport_Club_do_Recife_players	18	27	-9	-0.5
Saša_Ćurčić	wikicat_Yugoslavia_international_footballers	22	33	-11	-0.5
Horace_Williams	wikicat_Dundee_United_F.C._players	46	69	-23	-0.5
Awvee_Storey	wikicat_Undrafted_National_Basketball_Association_players	16	24	-8	-0.5
Harlow	wikicat_Local_government_districts_of_the_East_of_England	16	24	-8	-0.5
Egypt	wikicat_Developing_8_Countries_member_states	18	27	-9	-0.5
Nick_McKoy	wikicat_Grays_Athletic_F.C._players	18	27	-9	-0.5
Ambika_(actress)	wikicat_Actresses_in_Tamil_cinema	2	3	-1	-0.5
Lee_Johnson_(footballer)	wikicat_Bristol_City_F.C._players	2	3	-1	-0.5
Sani_Kaita	wikicat_FC_Kuban_Krasnodar_players	2	3	-1	-0.5
Georgetown,_Guyana	wikicat_Capitals	4	6	-2	-0.5
Amlash_County	wikicat_Counties_of_Gilan_Province	8	12	-4	-0.5
Scotland	wikicat_Autonomous_country_subdivisions	2	3	-1	-0.5
Ilija_Najdoski	wikicat_Expatriate_footballers_in_Spain	2	3	-1	-0.5
Lazarus_Fuchs	wikicat_19th-century_German_mathematicians	2	3	-1	-0.5
Marcos_Paulo_Alves	wikicat_FC_Metalist_Kharkiv_players	2	3	-1	-0.5
Poland_national_football_team	wikicat_European_national_association_football_teams	2	3	-1	-0.5
Derek_Parlane	wikicat_Scottish_Football_League_players	2	3	-1	-0.5
Saint-Jérôme,_Quebec	wikicat_Cities_and_towns_in_Quebec	2	3	-1	-0.5
Paul_Simon	wikicat_American_guitarists	4	6	-2	-0.5
Terrel_Castle	wikicat_American_expatriate_basketball_people_in_Spain	4	6	-2	-0.5
Newcastle_upon_Tyne	wordnet_administrative_district_108491826	2	3	-1	-0.5
Lemar	wikicat_British_musicians	2	3	-1	-0.5
Maurice_Starr	wikicat_African-American_songwriters	2	3	-1	-0.5
Kemi	wikicat_Populated_coastal_places_in_Finland	2	3	-1	-0.5
Jari_Litmanen	wikicat_Premier_League_players	8	12	-4	-0.5
Fabio_Bazzani	wikicat_21st-century_Italian_people	2	3	-1	-0.5
Matt_Dillon	wikicat_Living_people	4	6	-2	-0.5
Benjamin_Fondane	wikicat_Romanian_dramatists_and_playwrights	4	6	-2	-0.5
Ralph_Hasenhüttl	wikicat_2._Bundesliga_players	4	6	-2	-0.5
O._P._Nayyar	wikicat_Indian_people	4	6	-2	-0.5
Borough_of_Fylde	wikicat_Local_government_districts_of_North_West_England	2	3	-1	-0.5
Seol_Ki-hyeon	wikicat_Al-Hilal_FC_players	2	3	-1	-0.5
Natasha_Richardson	wikicat_English_film_actresses	2	3	-1	-0.5
Nicolae_Iorga	wikicat_20th-century_writers	2	3	-1	-0.5
Sugar_Land,_Texas	wikicat_Cities_in_Fort_Bend_County,_Texas	4	6	-2	-0.5
Jermain_Defoe	wikicat_People_from_London	2	3	-1	-0.5
Reinaldo_da_Cruz_Oliveira	wikicat_J._League_players	2	3	-1	-0.5
Héverton_Durães_Coutinho_Alves	wikicat_K_League_players	2	3	-1	-0.5
Josh_Schwartz	wikicat_American_soap_opera_writers	2	3	-1	-0.5
Steve_Croudson	wikicat_English_footballers	2	3	-1	-0.5
Newcastle_upon_Tyne	wikicat_Port_cities_and_towns_of_the_North_Sea	2	3	-1	-0.5
Velletri	wikicat_Communes_of_the_Province_of_Rome	2	3	-1	-0.5
Gustavo_Victoria	wikicat_Colombia_international_footballers	2	3	-1	-0.5
Curd_Jürgens	wikicat_German-language_film_directors	2	3	-1	-0.5
East_Azerbaijan_Province	wikicat_Provinces_of_Iran	2	3	-1	-0.5
Robert_Robinson_(organic_chemist)	wikicat_Presidents_of_the_Royal_Society	6	9	-3	-0.5
Montedio_Yamagata	wordnet_club_108227214	2	3	-1	-0.5
Morocco	wikicat_Arabic-speaking_countries_and_territories	2	3	-1	-0.5
Gene_Wilder	wikicat_21st-century_actors	2	3	-1	-0.5
ASK_Riga	wikicat_Euroleague-winning_clubs	6	9	-3	-0.5
Alexandria	wikicat_Ancient_Greek_cities	6	9	-3	-0.5
Fábio_José_dos_Santos	wikicat_J._League_Division_1_players	2	3	-1	-0.5
Rainer_Zobel	wikicat_Persepolis_F.C._managers	10644	15992	-5348	-0.5024426907177753
Kathy_Bates	wikicat_American_television_directors	159	239	-80	-0.5031446540880503
Washington,_D.C.	wikicat_Capitals_in_North_America	164	247	-83	-0.5060975609756098
Jesús_Franco	wikicat_Spanish_male_film_actors	11091	16705	-5614	-0.5061761788837796
Carl_Tiler	wikicat_Association_football_central_defenders	71	107	-36	-0.5070422535211268
Georg_Wilhelm_Friedrich_Hegel	wikicat_19th-century_educators	399	603	-204	-0.5112781954887218
Bechara_Oliveira	wikicat_Fortaleza_Esporte_Clube_players	43	65	-22	-0.5116279069767442
Sarah_Jessica_Parker	wikicat_UNICEF_people	333	505	-172	-0.5165165165165165
Yale_University	wikicat_Universities_and_colleges_in_New_Haven_County,_Connecticut	121	184	-63	-0.5206611570247934
Denis_Leary	wikicat_Irish_male_comedians	10805	16439	-5634	-0.5214252660805183
Milovan_Milović	wikicat_FK_Bežanija_players	199	303	-104	-0.5226130653266332
Carlos_Salazar_(Colombian_footballer)	wikicat_CSD_Colo-Colo_players	42	64	-22	-0.5238095238095238
Dean_Gordon	wikicat_People_from_Croydon	538	821	-283	-0.5260223048327137
Skopje	wordnet_administrative_district_108491826	19	29	-10	-0.5263157894736842
Martin_Rees,_Baron_Rees_of_Ludlow	wikicat_British_scientists	55	84	-29	-0.5272727272727272
Jacques_Chirac	wikicat_Officers_of_the_National_Order_of_Quebec	17	26	-9	-0.5294117647058824
Terence_Winter	wikicat_New_York_University_alumni	1069	1639	-570	-0.5332086061739943
Marius_Niculae	wikicat_1._FSV_Mainz_05_players	854	1310	-456	-0.5339578454332553
Leah_Laiman	wikicat_American_soap_opera_writers	2394	3673	-1279	-0.5342522974101922
Sky_Blue_FC	wikicat_New_Jersey_soccer_clubs	43	66	-23	-0.5348837209302325
Albert_Einstein	wikicat_American_humanitarians	1133	1740	-607	-0.5357458075904677
Marijo_Marić	wikicat_VfB_Stuttgart_II_players	54	83	-29	-0.5370370370370371
Alain_Juppé	wikicat_Lycée_Louis-le-Grand_alumni	13	20	-7	-0.5384615384615384
Vero_Beach,_Florida	wikicat_Beaches_of_Florida	13	20	-7	-0.5384615384615384
Paweł_Buśkiewicz	wikicat_Association_football_forwards	13	20	-7	-0.5384615384615384
Ömer_Erdoğan	wikicat_People_from_Kassel	9039	13937	-4898	-0.5418741011173802
George_Berkeley	wikicat_English_philosophers	35	54	-19	-0.5428571428571428
Nikopol,_Ukraine	wikicat_Cities_in_Dnipropetrovsk_Oblast	11	17	-6	-0.5454545454545454
Dan_Castellaneta	wikicat_American_people_of_Italian_descent	22	34	-12	-0.5454545454545454
Reno	wikicat_County_seats_in_Nevada	9671	14974	-5303	-0.5483403991314239
Peter_Debye	wikicat_People_from_Ithaca,_New_York	20	31	-11	-0.55
Mike_Ambersley	wikicat_USL_Premier_Development_League_players	20	31	-11	-0.55
Lemar	wikicat_Soul_musicians	38	59	-21	-0.5526315789473685
Charles_Lederer	wikicat_People_from_New_York_City	9	14	-5	-0.5555555555555556
Karl_Marx	wikicat_German_journalists	212	330	-118	-0.5566037735849056
Hervé_Gaymard	wikicat_French_Ministers_of_Agriculture	41	64	-23	-0.5609756097560976
Mitt_Romney	wikicat_American_management_consultants	9862	15407	-5545	-0.5622591766375988
Anne_Arundel_County,_Maryland	wikicat_Maryland_counties	39	61	-22	-0.5641025641025641
Paul_Robinson_(footballer,_born_1984)	wikicat_Newcastle_Blue_Star_F.C._players	395	619	-224	-0.5670886075949367
Continental_Basketball_Association	wikicat_Defunct_basketball_leagues	9524	14956	-5432	-0.5703485930281395
Jamil_Fearrington	wikicat_Association_football_central_defenders	142	223	-81	-0.5704225352112676
Al-Taawon_FC	wikicat_Sports_clubs_established_in_1956	9094	14290	-5196	-0.571365735649879
Matt_Carmichael_(footballer)	wikicat_Association_football_forwards	7	11	-4	-0.5714285714285714
Rosemary_Clooney	wikicat_Concord_Records_artists	28	44	-16	-0.5714285714285714
Fred_Zinnemann	wikicat_American_people_of_Austrian-Jewish_descent	7	11	-4	-0.5714285714285714
Serge_Gainsbourg	wikicat_New_wave_musicians	9888	15544	-5656	-0.5720064724919094
Silvio_Berlusconi	wikicat_People_from_Milan	496	781	-285	-0.5745967741935484
Clifford_Geertz	wikicat_American_male_writers	460	725	-265	-0.5760869565217391
Montclair,_New_Jersey	wikicat_Townships_in_New_Jersey	9182	14482	-5300	-0.5772162927466783
The_Animatrix	wikicat_Direct-to-video_films	8839	13953	-5114	-0.5785722366783573
Pescara	wordnet_administrative_district_108491826	12	19	-7	-0.5833333333333334
ABC_Futebol_Clube	wordnet_club_108227214	143	227	-84	-0.5874125874125874
Roberto_Merino	wikicat_Servette_FC_players	61	97	-36	-0.5901639344262295
New_York_Cosmos	wikicat_Association_football_clubs_established_in_1971	2548	4053	-1505	-0.5906593406593407
CS_Bourgoin-Jallieu	wikicat_Sports_clubs_established_in_1906	1102	1754	-652	-0.5916515426497277
Olivia_Newton-John	wikicat_British_actors	130	207	-77	-0.5923076923076923
Marcos_Paulo_Alves	wikicat_1999_FIFA_Confederations_Cup_players	736	1176	-440	-0.5978260869565217
Anne,_Princess_Royal	wikicat_English_people	5	8	-3	-0.6
Ilija_Najdoski	wikicat_Association_football_defenders	10	16	-6	-0.6
Flevoland	wikicat_Polders	2401	3843	-1442	-0.6005830903790087
Mohammadou_Idrissou	wikicat_MSV_Duisburg_players	58	93	-35	-0.603448275862069
Missoula,_Montana	wikicat_University_towns_in_the_United_States	2011	3239	-1228	-0.6106414719045251
Robert_B._Parker	wikicat_Thriller_writers	31	50	-19	-0.6129032258064516
Virginia_Beach,_Virginia	wikicat_Populated_places_established_in_1906	280	452	-172	-0.6142857142857143
Daphne_du_Maurier	wikicat_LGBT_novelists	78	126	-48	-0.6153846153846154
Communist_Party_of_Germany	wikicat_Political_parties_established_in_1918	9095	14693	-5598	-0.6155030236393623
Lionel_Carole	wikicat_CS_Sedan_Ardennes_players	21	34	-13	-0.6190476190476191
Nenad_Stojanović	wikicat_FK_Leotar_players	223	362	-139	-0.6233183856502242
Lon_Chaney_(Sr.)	wikicat_American_film_directors	8	13	-5	-0.625
Cannes	wikicat_Communes_of_Alpes-Maritimes	32	52	-20	-0.625
Paulo_Sérgio_Moreira_Gonçalves	wikicat_Segunda_Divisão_players	8	13	-5	-0.625
Mamadou_Bagayoko	wikicat_Doncaster_Rovers_F.C._players	198	322	-124	-0.6262626262626263
Mark_Peat	wikicat_Montrose_F.C._players	27	44	-17	-0.6296296296296297
David_Byrne	wikicat_Scottish_emigrants_to_the_United_States	7861	12811	-4950	-0.629690879023025
Erison_da_Silva_Santos	wikicat_PFC_Slavia_Sofia_players	160	262	-102	-0.6375
Staples_Center	wikicat_Basketball_venues	9812	16075	-6263	-0.6383000407664084
Donald_Crisp	wikicat_English_emigrants_to_the_United_States	25	41	-16	-0.64
Leon_Best	wikicat_A.F.C._Bournemouth_players	39	64	-25	-0.6410256410256411
INXS	wikicat_Australian_alternative_rock_groups	8912	14627	-5715	-0.641270197486535
Marta_(footballer)	wikicat_Club_de_Regatas_Vasco_da_Gama_players	76	125	-49	-0.6447368421052632
Evgeny_Yarovenko	wikicat_Ukrainian_football_managers	17	28	-11	-0.6470588235294118
Pierre_Pflimlin	wikicat_French_Ministers_of_Agriculture	17	28	-11	-0.6470588235294118
Finland	wordnet_area_108497294	1178	1941	-763	-0.6477079796264855
Ian_McLagan	wikicat_English_rock_keyboardists	23	38	-15	-0.6521739130434783
David_Shire	wikicat_Yale_University_alumni	303	501	-198	-0.6534653465346535
Ilan_Bakhar	wikicat_People_from_Tel_Aviv_District	26	43	-17	-0.6538461538461539
Luigi_De_Canio	wikicat_Expatriate_football_managers_in_England	1515	2515	-1000	-0.6600660066006601
Tamil_Nadu	wordnet_administrative_district_108491826	648	1077	-429	-0.6620370370370371
Émerson_Leão	wikicat_1986_FIFA_World_Cup_players	3	5	-2	-0.6666666666666666
Sani_Kaita	wikicat_Olympic_footballers_of_Nigeria	6	10	-4	-0.6666666666666666
Lasha_Jakobia	wikicat_Expatriate_footballers_in_Romania	6	10	-4	-0.6666666666666666
England_national_under-21_football_team	wikicat_England_national_football_teams	3	5	-2	-0.6666666666666666
Joseph_Stiglitz	wikicat_Jewish_American_social_scientists	3	5	-2	-0.6666666666666666
Kano	wordnet_administrative_district_108491826	12	20	-8	-0.6666666666666666
Raoul_Magrin-Vernerey	wikicat_Companions_of_the_Liberation	3	5	-2	-0.6666666666666666
Gregory_Peck	wikicat_21st-century_actors	3	5	-2	-0.6666666666666666
Dário_Monteiro	wikicat_Expatriate_footballers_in_the_United_Arab_Emirates	45	75	-30	-0.6666666666666666
Jacques_Chirac	wikicat_French_Ministers_of_Agriculture	39	65	-26	-0.6666666666666666
Johnny_Mandel	wikicat_American_jazz_composers	3	5	-2	-0.6666666666666666
Sylvia_Plath	wikicat_American_poets	3	5	-2	-0.6666666666666666
Pepe_Reina	wikicat_UEFA_Euro_2012_players	66	110	-44	-0.6666666666666666
Gene_Kelly	wikicat_Kennedy_Center_honorees	3	5	-2	-0.6666666666666666
Nalanda_district	wikicat_Districts_of_Bihar	3	5	-2	-0.6666666666666666
Janet_Leigh	wikicat_People_from_Stockton,_California	3	5	-2	-0.6666666666666666
Romeo_Filipović	wikicat_FK_Željezničar_players	3	5	-2	-0.6666666666666666
Julianne_Moore	wikicat_American_stage_actors	3	5	-2	-0.6666666666666666
Zemun	wikicat_Populated_places_in_Syrmia	7349	12289	-4940	-0.6722002993604572
Université_libre_de_Bruxelles	wikicat_Universities_in_Belgium	9831	16451	-6620	-0.6733801240972435
Werner_Heisenberg	wikicat_Philosophers_of_science	74	124	-50	-0.6756756756756757
David_Arquette	wikicat_Jewish_American_writers	136	228	-92	-0.6764705882352942
John_Ruskin	wikicat_British_socialists	1017	1707	-690	-0.6784660766961652
Netherlands_national_football_team	wikicat_National_sports_teams_of_the_Netherlands	25	42	-17	-0.68
Joventut_Badalona	wikicat_Basketball_clubs_established_in_1930	6793	11414	-4621	-0.6802590902399529
Fritz_Lang	wikicat_American_people_of_Austrian_descent	241	405	-164	-0.6804979253112033
Steve_Torpey_(footballer,_born_1981)	wikicat_Fleetwood_Town_F.C._players	35	59	-24	-0.6857142857142857
Santiago_Cañizares	wikicat_Footballers_at_the_1992_Summer_Olympics	390	659	-269	-0.6897435897435897
Bobby_Weale	wikicat_Cardiff_City_F.C._players	52	88	-36	-0.6923076923076923
Artavazd_Karamyan	wikicat_FC_Steaua_București_players	262	444	-182	-0.6946564885496184
Jerome_Beasley	wikicat_Miami_Heat_players	118	200	-82	-0.6949152542372882
Liv_Tyler	wikicat_Actresses_from_New_York_City	10	17	-7	-0.7
George_Abbott	wikicat_American_autobiographers	77	131	-54	-0.7012987012987013
Insurgency_in_the_Maghreb_(2002–present)	wikicat_Ongoing_insurgencies	47	80	-33	-0.7021276595744681
Alexander_Søderlund	wikicat_Expatriate_footballers_in_Italy	265	452	-187	-0.7056603773584905
John_Farnham	wikicat_Australian_male_singers	17	29	-12	-0.7058823529411765
Chelan_County,_Washington	wikicat_North_Cascades_of_Washington_(state)	9440	16139	-6699	-0.7096398305084746
Sheffield	wikicat_Local_government_districts_in_South_Yorkshire	8494	14550	-6056	-0.7129738639039321
Corfu	wikicat_Mediterranean_port_cities_and_towns_in_Greece	7	12	-5	-0.7142857142857143
John_McCain	wikicat_Living_people	7	12	-5	-0.7142857142857143
Bernie_Lilavois	wikicat_USL_First_Division_players	7	12	-5	-0.7142857142857143
Mos_Def	wikicat_Alternative_hip_hop_musicians	609	1045	-436	-0.715927750410509
Craig_McAllister	wikicat_Crawley_Town_F.C._players	199	342	-143	-0.7185929648241206
Pascal_Zuberbühler	wikicat_Association_football_goalkeepers	36	62	-26	-0.7222222222222222
Hérens_(district)	wikicat_Districts_of_Valais	7387	12724	-5337	-0.722485447407608
Gene_Wilder	wikicat_American_people_of_Russian-Jewish_descent	87	150	-63	-0.7241379310344828
Josiesley_Ferreira_Rosa	wikicat_SC_Farense_players	40	69	-29	-0.725
Jan_Budtz	wikicat_Wolverhampton_Wanderers_F.C._players	51	88	-37	-0.7254901960784313
Bret_McKenzie	wikicat_Living_people	11	19	-8	-0.7272727272727273
Paulo_César_Rodrigues_Lima	wikicat_Brujas_FC_players	320	553	-233	-0.728125
Arbroath	wikicat_Post_towns_in_the_DD_postcode_area	37	64	-27	-0.7297297297297297
Setagaya,_Tokyo	wikicat_1964_Summer_Olympic_venues	8738	15121	-6383	-0.7304875257495994
Bernardo_Tengarrinha	wikicat_Vitória_F.C._players	15	26	-11	-0.7333333333333333
Goole_A.F.C.	wordnet_club_108227214	15	26	-11	-0.7333333333333333
Lacina_Traoré	wikicat_Everton_F.C._players	882	1532	-650	-0.7369614512471655
Taranto	wikicat_Port_cities_and_towns_in_Italy	27	47	-20	-0.7407407407407407
Daniel_Arismendi	wikicat_Torneo_Descentralizado_footballers	62	108	-46	-0.7419354838709677
George_Orwell	wikicat_British_people_of_the_Spanish_Civil_War	292	509	-217	-0.7431506849315068
Dimba	wikicat_Brasiliense_Futebol_Clube_players	59	103	-44	-0.7457627118644068
War_of_the_Second_Coalition	wikicat_Wars_involving_the_United_States	8	14	-6	-0.75
Álvaro_del_Moral	wikicat_Association_football_forwards	8	14	-6	-0.75
Ivan_Dragičević	wikicat_FK_Mogren_players	12	21	-9	-0.75
Inglourious_Basterds	wikicat_German_drama_films	12	21	-9	-0.75
George_Abbott	wikicat_Pulitzer_Prize_winners	20	35	-15	-0.75
Jean-Paul_Sartre	wikicat_French_novelists	12	21	-9	-0.75
Andriy_Kruhlyak	wikicat_FC_Arsenal_Kyiv_players	8	14	-6	-0.75
Naples	wikicat_Archaeological_sites_in_Italy	8	14	-6	-0.75
Seïd_Khiter	wikicat_French_people_of_Algerian_descent	4	7	-3	-0.75
David_Lynch	wikicat_American_rock_musicians	4	7	-3	-0.75
Segundo_Castillo	wikicat_Ecuadorian_people_of_African_descent	16	28	-12	-0.75
Halmahera	wikicat_Islands_of_Indonesia	12	21	-9	-0.75
North_African_Campaign	wikicat_Battles_and_operations_of_World_War_II_involving_India	4	7	-3	-0.75
Isidor_Isaac_Rabi	wikicat_Columbia_University_alumni	4	7	-3	-0.75
John_Cleese	wikicat_English_male_radio_actors	4	7	-3	-0.75
Klaus_Toppmöller	wikicat_Germany_B_international_footballers	4	7	-3	-0.75
Dominic_Foley	wikicat_Queens_Park_Rangers_F.C._players	4	7	-3	-0.75
Indonesia	wikicat_States_and_territories_established_in_1949	70	123	-53	-0.7571428571428571
Krasnodar	wikicat_Cities_and_towns_in_Krasnodar_Krai	8104	14248	-6144	-0.7581441263573544
Le_Tampon	wikicat_Communes_of_Réunion	8128	14299	-6171	-0.7592273622047244
University_of_Detroit_Mercy	wikicat_Universities_and_colleges_in_Detroit,_Michigan	8433	14903	-6470	-0.7672240009486541
Generoso_Rossi	wikicat_Queens_Park_Rangers_F.C._players	417	737	-320	-0.7673860911270983
Stephen_Bywater	wikicat_Association_football_goalkeepers	13	23	-10	-0.7692307692307693
Second_Boer_War	wikicat_Wars_involving_South_Africa	9	16	-7	-0.7777777777777778
Mario_Yepes	wikicat_Paris_Saint-Germain_F.C._players	81	144	-63	-0.7777777777777778
Ludwig_Wittgenstein	wikicat_Prisoners_of_war	2458	4371	-1913	-0.7782750203417412
Luxembourg	wikicat_Divided_regions	46	82	-36	-0.782608695652174
50_Cent	wikicat_Shady_Records_artists	97	173	-76	-0.7835051546391752
Johann_Gottlieb_Fichte	wikicat_Idealists	14	25	-11	-0.7857142857142857
Karl_Marx	wikicat_Historians_of_economic_thought	252	450	-198	-0.7857142857142857
Russ_Tamblyn	wikicat_American_male_dancers	273	489	-216	-0.7912087912087912
Wallace_Shawn	wikicat_Jewish_comedians	29	52	-23	-0.7931034482758621
John_Badham	wikicat_Yale_University_alumni	846	1520	-674	-0.7966903073286052
Tirana	wikicat_Cities_in_Albania	9325	16771	-7446	-0.7984986595174263
Laurie_R._King	wikicat_American_women_novelists	5	9	-4	-0.8
Maroš_Klimpl	wikicat_MFK_Ružomberok_players	10	18	-8	-0.8
Joan_Capdevila	wikicat_Atlético_Madrid_footballers	5	9	-4	-0.8
Mamoru_Oshii	wikicat_People_from_Tokyo	5	9	-4	-0.8
Yuen_Biao	wikicat_Chinese_film_directors	10	18	-8	-0.8
FC_Metalurh_Donetsk	wikicat_Association_football_clubs_established_in_1996	5	9	-4	-0.8
Georgios_Vakouftsis	wikicat_Skoda_Xanthi_F.C._players	5	9	-4	-0.8
Mauro_Bressan	wikicat_FC_Chiasso_players	6670	12008	-5338	-0.8002998500749625
Daniel_Nannskog	wikicat_Norwegian_First_Division_players	46	83	-37	-0.8043478260869565
Cameron_Mitchell_(actor)	wikicat_American_people_of_Scottish_descent	31	56	-25	-0.8064516129032258
Rollins_College	wikicat_Educational_institutions_established_in_1885	119	215	-96	-0.8067226890756303
Chakhir_Belghazouani	wikicat_French_people_of_Moroccan_descent	115	208	-93	-0.808695652173913
Nikola_Jozić	wikicat_Eintracht_Frankfurt_players	227	411	-184	-0.8105726872246696
Turan_Tovuz_PFK	wikicat_Association_football_clubs_established_in_1954	234	424	-190	-0.811965811965812
Carl_Sagan	wikicat_Agnostics	64	116	-52	-0.8125
Bruno_Šundov	wikicat_CB_Lucentum_Alicante_players	161	292	-131	-0.8136645962732919
Mitt_Romney	wikicat_German_emigrants_to_the_United_States	27	49	-22	-0.8148148148148148
Reto_Ziegler	wikicat_Switzerland_international_footballers	11	20	-9	-0.8181818181818182
Narbonne	wikicat_Roman_towns_and_cities_in_France	11	20	-9	-0.8181818181818182
Namco	wikicat_Video_game_companies_of_Japan	11	20	-9	-0.8181818181818182
Florida_A&M_University	wikicat_Universities_and_colleges_in_Leon_County,_Florida	17	31	-14	-0.8235294117647058
Vijay_(actor)	wikicat_Loyola_College,_Chennai_alumni	40	73	-33	-0.825
Dario_Smoje	wikicat_A.C._Milan_players	360	659	-299	-0.8305555555555556
Iran	wikicat_Developing_8_Countries_member_states	6	11	-5	-0.8333333333333334
Fred_Zinnemann	wikicat_German-language_film_directors	6	11	-5	-0.8333333333333334
Roger_Ebert	wikicat_American_agnostics	6	11	-5	-0.8333333333333334
Mario_Cáceres	wikicat_Liga_MX_footballers	177	325	-148	-0.8361581920903954
Gheorghe_Hagi	wikicat_Bursaspor_managers	3873	7133	-3260	-0.841724761167054
Julian_Schwinger	wikicat_Jewish_American_scientists	19	35	-16	-0.8421052631578947
Alexander_Herzen	wikicat_People_from_Moscow_Governorate	19	35	-16	-0.8421052631578947
Nicola_Amoruso	wikicat_Italy_under-21_international_footballers	13	24	-11	-0.8461538461538461
Henry_Adams	wikicat_American_people_of_British_descent	33	61	-28	-0.8484848484848485
Heiðar_Helguson	wikicat_Fulham_F.C._players	40	74	-34	-0.85
Bad_Honnef	wikicat_Populated_places_on_the_Rhine	7	13	-6	-0.8571428571428571
Lemar	wikicat_British_male_singers	7	13	-6	-0.8571428571428571
Matthew_Collins	wikicat_Swindon_Town_F.C._players	35	65	-30	-0.8571428571428571
FK_Viktoria_Žižkov	wikicat_Association_football_clubs_established_in_1903	554	1029	-475	-0.8574007220216606
Jason_Blunt	wikicat_Goole_A.F.C._players	65	121	-56	-0.8615384615384616
University_of_San_Francisco	wikicat_Universities_and_colleges_in_Sacramento_County,_California	7683	14305	-6622	-0.8619029025120396
Jamie_Lee_Curtis	wikicat_American_people_of_Danish_descent	73	136	-63	-0.863013698630137
Levan_Maghradze	wikicat_Skoda_Xanthi_F.C._players	66	123	-57	-0.8636363636363636
Gustavo_Victoria	wikicat_Converts_to_Islam	130	243	-113	-0.8692307692307693
Ismael_Santiago_López	wikicat_Xerez_CD_players	23	43	-20	-0.8695652173913043
Ilian_Iliev	wikicat_Bulgarian_football_managers	277	518	-241	-0.8700361010830325
Joseph_Stiglitz	wikicat_Academics_of_the_University_of_Manchester	383	718	-335	-0.8746736292428199
Murat_Şahin	wikicat_People_from_Istanbul	8	15	-7	-0.875
Aaran_Lines	wikicat_SV_Werder_Bremen_players	240	450	-210	-0.875
Nick_Cave	wikicat_Australian_male_singers	8	15	-7	-0.875
Kurt_Vonnegut	wikicat_United_States_Army_soldiers	8	15	-7	-0.875
Maximilian_Heidenreich	wikicat_SC_Freiburg_players	25	47	-22	-0.88
Sean_Clancy	wikicat_England_semi-pro_international_footballers	85	160	-75	-0.8823529411764706
Keijo_Huusko	wikicat_BK_Häcken_players	95	179	-84	-0.8842105263157894
Heybridge_Swifts_F.C.	wikicat_Association_football_clubs_established_in_1880	289	545	-256	-0.8858131487889274
Ricardo_Villar_(Brazilian_footballer)	wikicat_Brazilian_expatriates_in_Austria	8758	16527	-7769	-0.8870746745832382
Amartya_Sen	wikicat_Fellows_of_the_American_Academy_of_Arts_and_Sciences	9	17	-8	-0.8888888888888888
Dennis_Rodman	wikicat_Dallas_Mavericks_players	9	17	-8	-0.8888888888888888
Michael_Lamey	wikicat_AZ_Alkmaar_players	46	87	-41	-0.8913043478260869
St._Charles_County,_Missouri	wikicat_Missouri_counties_on_the_Mississippi_River	9165	17369	-8204	-0.8951445717403165
Greg_Bear	wikicat_20th-century_writers	251	476	-225	-0.896414342629482
Anagennisi_Karditsa_F.C.	wikicat_Sports_clubs_established_in_1904	438	831	-393	-0.8972602739726028
Charlotte_Gainsbourg	wikicat_English_people_of_French_descent	668	1271	-603	-0.9026946107784432
Steven_Spielberg	wikicat_Directors	33	63	-30	-0.9090909090909091
Nikita_Rukavytsya	wikicat_K.S.V._Roeselare_players	143	273	-130	-0.9090909090909091
Gregory_Peck	wikicat_20th_Century_Fox_contract_players	22	42	-20	-0.9090909090909091
Jason_Minett	wikicat_Doncaster_Rovers_F.C._players	11	21	-10	-0.9090909090909091
Wolfgang_Frank	wikicat_German_expatriate_footballers	45	86	-41	-0.9111111111111111
Spanish_language	wikicat_Languages_of_Equatorial_Guinea	34	65	-31	-0.9117647058823529
Jean-Emmanuel_Effa_Owona	wikicat_Elazığspor_footballers	195	373	-178	-0.9128205128205128
Vanderlei_Mascarenhas_dos_Santos	wikicat_Clube_Atlético_Bragantino_players	70	134	-64	-0.9142857142857143
San_Diego_State_University	wikicat_Schools_accredited_by_the_Western_Association_of_Schools_and_Colleges	12	23	-11	-0.9166666666666666
Gerry_Francis	wikicat_Crystal_Palace_F.C._players	12	23	-11	-0.9166666666666666
Robert_Anton_Wilson	wikicat_Conspiracy_theorists	757	1452	-695	-0.9180977542932629
Randers_FC	wikicat_Association_football_clubs_established_in_2003	5667	10877	-5210	-0.9193576848420681
Millwall_F.C.	wikicat_Association_football_clubs_established_in_1885	25	48	-23	-0.92
John_McCain	wikicat_Military_brats	1411	2711	-1300	-0.9213323883770376
Alexandre_Lopes	wikicat_FC_Spartak_Moscow_players	481	926	-445	-0.9251559251559252
George_Oghani	wikicat_Guiseley_A.F.C._players	399	769	-370	-0.9273182957393483
Keanu_Reeves	wikicat_American_atheists	727	1402	-675	-0.9284731774415406
Fausto_Lourenço	wikicat_Expatriate_footballers_in_Kazakhstan	1489	2876	-1387	-0.931497649429147
Derek_Yee	wikicat_Hong_Kong_people_of_Manchu_descent	15	29	-14	-0.9333333333333333
Gordan_Petrić	wikicat_Yugoslavia_international_footballers	47	91	-44	-0.9361702127659575
Liam_Lawrence	wikicat_Barnsley_F.C._players	65	126	-61	-0.9384615384615385
Marcin_Mięciel	wikicat_PAOK_FC_players	234	454	-220	-0.9401709401709402
Las_Palmas	wikicat_Canary_Islands	8193	15921	-7728	-0.9432442328817283
Joe_Addo	wikicat_FSV_Frankfurt_players	1307	2544	-1237	-0.946442234123948
Éric_Besson	wikicat_Socialist_Party_(France)_politicians	19	37	-18	-0.9473684210526315
Luis_Flores_(basketball)	wikicat_Golden_State_Warriors_players	39	76	-37	-0.9487179487179487
New_Orleans	wikicat_Louisiana_populated_places_on_the_Mississippi_River	7994	15579	-7585	-0.9488366274706029
Yakir_Aharonov	wikicat_Jewish_scientists	20	39	-19	-0.95
U.S._Pergolettese_1932	wikicat_Association_football_clubs_established_in_1932	221	431	-210	-0.9502262443438914
Cape_Town_City_F.C.	wikicat_Association_football_clubs_established_in_1960	3361	6574	-3213	-0.9559654864623623
Giuseppe_Verdi	wordnet_artist_109812338	24	47	-23	-0.9583333333333334
Harvard_Business_School	wikicat_Educational_institutions_established_in_1908	73	143	-70	-0.958904109589041
Agadir	wikicat_Spa_towns	471	923	-452	-0.9596602972399151
M._T._Vasudevan_Nair	wikicat_Indian_writers	27	53	-26	-0.9629629629629629
Grigori_Perelman	wikicat_Living_people	55	108	-53	-0.9636363636363636
Werner_Heisenberg	wikicat_Knight_Commanders_of_the_Order_of_Merit_of_the_Federal_Republic_of_Germany	84	165	-81	-0.9642857142857143
Dorge_Kouemaha	wikicat_Aris_Thessaloniki_F.C._players	477	947	-470	-0.9853249475890985
Richard_Garcia	wikicat_North_American_Soccer_League_players	1081	2159	-1078	-0.9972247918593895
Paulo_Figueiredo	wikicat_People_from_Luanda	3	6	-3	-1.0
United_Arab_Emirates	wikicat_Member_states_of_the_Cooperation_Council_for_the_Arab_States_of_the_Gulf	3	6	-3	-1.0
China	wikicat_East_Asian_countries	4	8	-4	-1.0
Nick_Cave	wikicat_English-language_singers	14	28	-14	-1.0
Devon	wordnet_county_108546183	12	24	-12	-1.0
Xavier_Gravelaine	wikicat_Paris_Saint-Germain_F.C._players	20	40	-20	-1.0
Émerson_Leão	wikicat_São_José_Esporte_Clube_players	28	56	-28	-1.0
Cândido_Costa	wikicat_C.F._Os_Belenenses_players	31	62	-31	-1.0
Mary_Astor	wikicat_Paramount_Pictures_contract_players	12	24	-12	-1.0
Panathinaikos_B.C.	wikicat_Euroleague-winning_clubs	3	6	-3	-1.0
Ross_Macdonald	wikicat_English-language_writers	1	2	-1	-1.0
Santiago_Salcedo	wikicat_Expatriate_footballers_in_Turkey	1	2	-1	-1.0
Julia_Kristeva	wikicat_20th-century_philosophers	5	10	-5	-1.0
Wallonia	wikicat_Regions_of_Belgium	1	2	-1	-1.0
Edmund_Gwenn	wikicat_British_people	1	2	-1	-1.0
Steven_Spielberg	wikicat_Jewish_American_male_actors	6	12	-6	-1.0
Pedro_León	wikicat_La_Liga_footballers	1	2	-1	-1.0
Fábio_José_dos_Santos	wikicat_J._League_Division_2_players	7	14	-7	-1.0
Robin_Cook_(American_novelist)	wikicat_21st-century_American_novelists	1	2	-1	-1.0
Joseph-Désiré_Job	wikicat_Expatriate_footballers_in_England	3	6	-3	-1.0
Scarborough_F.C.	wikicat_Defunct_Football_League_clubs	3	6	-3	-1.0
Marco_Delvecchio	wikicat_Brescia_Calcio_players	8	16	-8	-1.0
Aris_Thessaloniki_F.C.	wordnet_club_108227214	5	10	-5	-1.0
Steven_Pelé	wikicat_Stade_Rennais_F.C._players	1	2	-1	-1.0
John_Ireland_(actor)	wikicat_Canadian_people	5	10	-5	-1.0
Suat_Usta	wikicat_Turkey_under-21_international_footballers	3	6	-3	-1.0
Guy_Feutchine	wikicat_Superleague_Greece_players	1	2	-1	-1.0
Vyacheslav_Sviderskyi	wikicat_FC_Dynamo_Kyiv_players	3	6	-3	-1.0
Andrea_Cocco	wikicat_Italian_footballers	1	2	-1	-1.0
Paul_Dickov	wikicat_Blackpool_F.C._players	3	6	-3	-1.0
Kazakhstan	wikicat_Countries_in_Europe	3	6	-3	-1.0
Habib_Bamogo	wikicat_Panetolikos_players	3	6	-3	-1.0
Winston_Churchill	wikicat_British_journalists	10	20	-10	-1.0
Rosa_Luxemburg	wikicat_Marxist_writers	3	6	-3	-1.0
Matt_Dillon	wikicat_21st-century_actors	3	6	-3	-1.0
Muscat,_Oman	wordnet_administrative_district_108491826	3	6	-3	-1.0
Nine_Years'_War	wikicat_Global_conflicts	11	22	-11	-1.0
Vyacheslav_Sviderskyi	wikicat_FC_Dynamo_Moscow_players	6	12	-6	-1.0
Pete_Seeger	wikicat_American_buskers	3	6	-3	-1.0
Vanče_Šikov	wikicat_Macedonia_international_footballers	2	4	-2	-1.0
Godfrey_Ingram	wikicat_North_American_Soccer_League_(1968–84)_players	2	4	-2	-1.0
Peter_Fonda	wikicat_20th-century_actors	1	2	-1	-1.0
Czech_Republic_national_under-21_football_team	wikicat_European_national_under-21_association_football_teams	1	2	-1	-1.0
Västerbotten_County	wikicat_Counties_of_Sweden	1	2	-1	-1.0
Gregory_Peck	wikicat_21st-century_American_male_actors	1	2	-1	-1.0
Darryn_Stamp	wikicat_Gateshead_F.C._players	1	2	-1	-1.0
Charles_Fourier	wikicat_French_sociologists	1	2	-1	-1.0
Przasnysz_County	wikicat_Land_counties_of_Masovian_Voivodeship	8	16	-8	-1.0
Tübingen_(region)	wikicat_Government_regions_of_Germany	1	2	-1	-1.0
Matthew_Bellamy	wikicat_Lead_guitarists	4	8	-4	-1.0
Accra	wikicat_Port_cities	1	2	-1	-1.0
Lausanne	wikicat_Cantonal_capitals_of_Switzerland	1	2	-1	-1.0
Santiago_Cañizares	wikicat_Spanish_footballers	1	2	-1	-1.0
University_of_St_Andrews	wordnet_university_108286569	1	2	-1	-1.0
ACF_Fiorentina	wikicat_Serie_A_clubs	1	2	-1	-1.0
Geraldine_Chaplin	wikicat_21st-century_American_actresses	1	2	-1	-1.0
Peterborough_United_F.C.	wikicat_Football_League_clubs	1	2	-1	-1.0
Miloš_Dimitrijević	wikicat_Red_Star_Belgrade_footballers	1	2	-1	-1.0
Martin_Luther_King,_Jr.	wikicat_Fellows_of_the_American_Academy_of_Arts_and_Sciences	1	2	-1	-1.0
Hopkinsville,_Kentucky	wikicat_County_seats_in_Kentucky	1	2	-1	-1.0
Franz_Carr	wikicat_English_footballers	1	2	-1	-1.0
Billy_Corgan	wikicat_Guitarists	1	2	-1	-1.0
Lenny_Kravitz	wikicat_American_actors	1	2	-1	-1.0
UE_Lleida	wordnet_club_108227214	1	2	-1	-1.0
Ladislas_Douniama	wikicat_Ligue_1_players	1	2	-1	-1.0
Upper_Normandy	wikicat_NUTS_2_statistical_regions_of_the_European_Union	1	2	-1	-1.0
Anjelica_Huston	wikicat_21st-century_American_actresses	1	2	-1	-1.0
Jokerit	wordnet_hockey_team_108080386	1	2	-1	-1.0
Michael_Douglas	wikicat_21st-century_actors	1	2	-1	-1.0
Miklós_Horthy	wordnet_officeholder_110371450	1	2	-1	-1.0
June_Allyson	wikicat_American_stage_actors	1	2	-1	-1.0
Europe_Ecology_–_The_Greens	wikicat_Political_parties_of_the_Fifth_Republic	1	2	-1	-1.0
Matthew_Broderick	wikicat_People_from_New_York_City	1	2	-1	-1.0
Tandil	wikicat_Cities_in_Argentina	1	2	-1	-1.0
Club_Atlético_de_Madrid	wikicat_La_Liga_clubs	1	2	-1	-1.0
Lahore	wikicat_Cities_of_Pakistan	1	2	-1	-1.0
Pierre_Trudeau	wikicat_Alumni_of_the_London_School_of_Economics	1	2	-1	-1.0
Gordon_Milne	wikicat_The_Football_League_managers	1	2	-1	-1.0
Pierre_Bérégovoy	wikicat_Prime_Ministers_of_France	1	2	-1	-1.0
Sani_Kaita	wikicat_Footballers_at_the_2008_Summer_Olympics	1	2	-1	-1.0
Santiago_Salcedo	wikicat_Expatriate_footballers_in_Japan	1	2	-1	-1.0
O'Hare_International_Airport	wikicat_Airports_in_Cook_County,_Illinois	1	2	-1	-1.0
Johnny_Carson	wikicat_American_writers	6	12	-6	-1.0
Patsy_Cline	wikicat_American_female_singers	1	2	-1	-1.0
FC_Shakhtar-2_Donetsk	wikicat_Defunct_football_clubs_in_Ukraine	1	2	-1	-1.0
Meudon	wikicat_Cities_in_France	1	2	-1	-1.0
Judy_Garland	wikicat_American_singers	2	4	-2	-1.0
Shreveport,_Louisiana	wikicat_Parish_seats_in_Louisiana	1	2	-1	-1.0
Gheorghe_Hagi	wikicat_Expatriate_footballers_in_Italy	1	2	-1	-1.0
Thomas_Paine	wikicat_British_people	1	2	-1	-1.0
North_Brabant	wordnet_administrative_district_108491826	1	2	-1	-1.0
SK_Brann	wordnet_club_108227214	1	2	-1	-1.0
Arabic_language	wikicat_Languages_of_Lebanon	1	2	-1	-1.0
Richard_Logan_(footballer_born_1982)	wikicat_Cambridge_United_F.C._players	1	2	-1	-1.0
Amy_LePeilbet	wikicat_United_Soccer_Leagues_W-League_players	1	2	-1	-1.0
Cosenza_Calcio	wikicat_Lega_Pro_Prima_Divisione_clubs	1	2	-1	-1.0
Brownwood,_Texas	wordnet_administrative_district_108491826	1	2	-1	-1.0
Joshua_Jackson	wikicat_20th-century_American_actors	1	2	-1	-1.0
Tokushima,_Tokushima	wikicat_Populated_coastal_places_in_Japan	1	2	-1	-1.0
Rally_of_the_French_People	wikicat_Political_parties_in_France	1	2	-1	-1.0
Thomas_Mulcair	wikicat_Canadian_people	1	2	-1	-1.0
Russian_Civil_War	wikicat_Civil_wars	1	2	-1	-1.0
Andrija_Kaluđerović	wikicat_Serbian_expatriates_in_Spain	2	4	-2	-1.0
Tehachapi,_California	wordnet_administrative_district_108491826	2	4	-2	-1.0
Eastleigh_F.C.	wikicat_Southern_Football_League_clubs	2	4	-2	-1.0
Rubén_Piaggio	wikicat_Expatriate_footballers_in_Spain	2	4	-2	-1.0
Ramón_Núñez	wikicat_Liga_MX_footballers	1	2	-1	-1.0
Norberto_Huezo	wikicat_Expatriate_footballers_in_Guatemala	1	2	-1	-1.0
Wichita	wikicat_Populated_places_established_in_1863	1	2	-1	-1.0
Hugo_Carreira	wikicat_Expatriate_footballers_in_China	1	2	-1	-1.0
François_Hollande	wikicat_French_politicians	1	2	-1	-1.0
Tom_Brighton	wikicat_Scottish_Football_League_players	1	2	-1	-1.0
Iron_County,_Utah	wordnet_county_108546183	1	2	-1	-1.0
Ukraine	wikicat_States_and_territories_established_in_1991	1	2	-1	-1.0
Mark_Peat	wikicat_Stirling_Albion_F.C._players	1	2	-1	-1.0
Alexandro_da_Silva_Batista	wikicat_Pohang_Steelers_players	1	2	-1	-1.0
Joshua_Jackson	wikicat_20th-century_actors	1	2	-1	-1.0
Nicolás_Muñoz	wikicat_C.D._Aguila_footballers	1	2	-1	-1.0
Philip_Pullman	wikicat_20th-century_British_novelists	1	2	-1	-1.0
Southend_United_F.C.	wordnet_club_108227214	1	2	-1	-1.0
Sammo_Hung	wikicat_21st-century_Hong_Kong_male_actors	1	2	-1	-1.0
Emilia-Romagna	wordnet_administrative_district_108491826	1	2	-1	-1.0
Ronald_Fisher	wikicat_People_from_London	2	4	-2	-1.0
Voltaire	wikicat_French_essayists	2	4	-2	-1.0
Tam_McManus	wikicat_Falkirk_F.C._players	2	4	-2	-1.0
Nikita_Rukavytsya	wikicat_Australia_international_soccer_players	2	4	-2	-1.0
Portsmouth	wikicat_Port_cities_and_towns_in_England	1	2	-1	-1.0
Democratic_Alliance_(South_Africa)	wikicat_Liberal_parties	1	2	-1	-1.0
Laos	wikicat_Communist_states	1	2	-1	-1.0
Kelly_Smith	wikicat_Women's_United_Soccer_Association_players	1	2	-1	-1.0
Prescot_Cables_F.C.	wikicat_North_West_Counties_Football_League_clubs	1	2	-1	-1.0
Roy_Orbison	wikicat_American_male_singers	1	2	-1	-1.0
Mülheim	wikicat_Districts_of_North_Rhine-Westphalia	1	2	-1	-1.0
Lima	wordnet_administrative_district_108491826	1	2	-1	-1.0
Ludwig_Wittgenstein	wordnet_philosopher_110423589	1	2	-1	-1.0
Carla_Gugino	wikicat_American_people_of_English_descent	1	2	-1	-1.0
Dick_Cheney	wikicat_American_people_of_English_descent	1	2	-1	-1.0
Mumtaz_(actress)	wikicat_Actresses_in_Hindi_cinema	2	4	-2	-1.0
Worcester	wikicat_Cities_in_England	1	2	-1	-1.0
Edgar_Çani	wikicat_U.S._Città_di_Palermo_players	2	4	-2	-1.0
Francis_Ford_Coppola	wikicat_New_York_Military_Academy_alumni	1	2	-1	-1.0
Maastricht	wordnet_administrative_district_108491826	2	4	-2	-1.0
Kostyantyn_Kravchenko	wikicat_FC_Shakhtar_Donetsk_players	1	2	-1	-1.0
Julian_Schwinger	wikicat_Jewish_scientists	2	4	-2	-1.0
Saša_Ćurčić	wikicat_FK_Partizan_players	2	4	-2	-1.0
Daisuke_Matsui	wikicat_Expatriate_footballers_in_Russia	2	4	-2	-1.0
Zlatan_Ibrahimović	wikicat_Expatriate_footballers_in_Spain	1	2	-1	-1.0
Jimmy_Oliver	wikicat_American_expatriate_basketball_people_in_Spain	1	2	-1	-1.0
Giulietta_Masina	wikicat_Italian_film_actresses	2	4	-2	-1.0
Caroline_Seger	wikicat_Swedish_footballers	1	2	-1	-1.0
Worcester	wikicat_Villages_in_the_West_Midlands_(county)	1	2	-1	-1.0
François_Hollande	wikicat_People_from_Rouen	1	2	-1	-1.0
Namur	wikicat_Provincial_capitals_of_Wallonia	2	4	-2	-1.0
Molucca_Sea	wordnet_ocean_109376198	1	2	-1	-1.0
Steven_Spielberg	wikicat_20th-century_American_actors	2	4	-2	-1.0
Chuck_Norris	wikicat_20th-century_American_actors	1	2	-1	-1.0
FC_Chomutov	wordnet_club_108227214	2	4	-2	-1.0
Cincinnati	wikicat_Cities_in_Hamilton_County,_Ohio	2	4	-2	-1.0
Reto_Ziegler	wikicat_Swiss_footballers	2	4	-2	-1.0
CR_Vasco_da_Gama	wordnet_club_108227214	2	4	-2	-1.0
Luc_Nijholt	wikicat_Swindon_Town_F.C._players	2	4	-2	-1.0
NK_Triglav_Kranj	wordnet_club_108227214	2	4	-2	-1.0
C._V._Sridhar	wikicat_Indian_film_directors	1	2	-1	-1.0
Lasha_Jakobia	wikicat_FC_Zakarpattia_Uzhhorod_players	2	4	-2	-1.0
Helsinki	wikicat_Populated_coastal_places_in_Finland	1	2	-1	-1.0
Henry_Fonda	wikicat_American_television_actors	1	2	-1	-1.0
Le_streghe	wikicat_Italian-language_films	1	2	-1	-1.0
Burgundy	wordnet_region_108630039	1	2	-1	-1.0
Jinan	wikicat_Sub-provincial_cities_in_the_People's_Republic_of_China	1	2	-1	-1.0
Georges_Simenon	wikicat_Belgian_writers	1	2	-1	-1.0
Maccabi_Ahi_Nazareth_F.C.	wordnet_club_108227214	1	2	-1	-1.0
Nick_McKoy	wikicat_Football_Conference_players	1	2	-1	-1.0
James_Wesolowski	wikicat_The_Football_League_players	1	2	-1	-1.0
Hungary_national_football_team	wikicat_European_national_association_football_teams	1	2	-1	-1.0
Tarragona	wikicat_Archaeological_sites_in_Spain	1	2	-1	-1.0
Luke_Corbett	wikicat_English_footballers	1	2	-1	-1.0
Kingdom_of_Hanover	wikicat_Former_countries_in_Europe	2	4	-2	-1.0
Montpellier_HSC_(Ladies)	wordnet_club_108227214	1	2	-1	-1.0
Karl_Popper	wikicat_20th-century_philosophers	2	4	-2	-1.0
Italian_Liberal_Party	wikicat_Defunct_political_parties_in_Italy	1	2	-1	-1.0
Portland,_Maine	wikicat_Cities_in_Cumberland_County,_Maine	1	2	-1	-1.0
Kristian_Flittie_Onstad	wikicat_SK_Brann_players	1	2	-1	-1.0
Igor_Štimac	wikicat_Expatriate_footballers_in_Spain	1	2	-1	-1.0
Lower_Carniola	wikicat_Subdivisions_of_Carniola	1	2	-1	-1.0
Paulo_Marcel_Pereira_Merabet	wikicat_Expatriate_footballers_in_South_Korea	1	2	-1	-1.0
Ruth_Rendell	wikicat_Living_people	1	2	-1	-1.0
Vancouver_Island	wikicat_Islands_of_Canada	1	2	-1	-1.0
Anne_Shirley_(actress)	wikicat_Actors	1	2	-1	-1.0
Lethbridge_Hurricanes	wordnet_hockey_team_108080386	1	2	-1	-1.0
Prijepolje	wikicat_Populated_places_in_Zlatibor_District	1	2	-1	-1.0
Yevhen_Lutsenko	wikicat_Ukrainian_Premier_League_players	1	2	-1	-1.0
Port_of_Spain	wikicat_Port_cities_in_the_Caribbean	1	2	-1	-1.0
Arthur_Moses	wikicat_People_from_Accra	1	2	-1	-1.0
Nicolás_Diez	wikicat_Deportivo_Táchira_players	1	2	-1	-1.0
Marc_Arnold	wikicat_Expatriate_footballers_in_Germany	1	2	-1	-1.0
Jürgen_Moser	wikicat_American_people	1	2	-1	-1.0
Bangkok	wikicat_Populated_places_established_in_the_18th_century	359	721	-362	-1.0083565459610029
Serge_Gainsbourg	wikicat_Mercury_Records_artists	113	227	-114	-1.008849557522124
Barack_Obama	wikicat_American_male_writers	175	353	-178	-1.0171428571428571
Jacques_Chaban-Delmas	wikicat_Transport_ministers_of_France	40	81	-41	-1.025
Julianne_Moore	wikicat_American_children's_writers	602	1220	-618	-1.026578073089701
FK_Šilutė	wikicat_Football_clubs_in_Lithuania	70	142	-72	-1.0285714285714285
Dave_Mooney	wikicat_Reading_F.C._players	86	175	-89	-1.0348837209302326
Gene_Wilder	wikicat_American_writers	96	196	-100	-1.0416666666666667
Communist_Party_of_Czechoslovakia	wikicat_Political_parties_in_Czechoslovakia	7857	16098	-8241	-1.0488736158839251
Alex_Notman	wikicat_Scotland_under-21_international_footballers	18	37	-19	-1.0555555555555556
David_Byrne	wikicat_Scottish_male_film_actors	189	389	-200	-1.0582010582010581
Felix_Ogbuke	wikicat_Expatriate_footballers_in_Norway	17	35	-18	-1.0588235294117647
Jerry_Pournelle	wikicat_American_journalists	33	68	-35	-1.0606060606060606
Club_León	wordnet_club_108227214	32	66	-34	-1.0625
Canada	wikicat_States_and_territories_established_in_1867	48	99	-51	-1.0625
Robert_G._Ingersoll	wikicat_American_lawyers	30	62	-32	-1.0666666666666667
Friedrich_Engels	wikicat_German_writers	419	867	-448	-1.0692124105011933
Clint_Marcelle	wikicat_Gainsborough_Trinity_F.C._players	53	110	-57	-1.0754716981132075
Unión_San_Felipe	wikicat_Association_football_clubs_established_in_1956	500	1041	-541	-1.082
Hamburg	wikicat_NUTS_1_statistical_regions_of_the_European_Union	33	69	-36	-1.0909090909090908
Andriy_Raspopov	wikicat_FK_Simurq_Zaqatala_players	31	65	-34	-1.096774193548387
Paul_Dirac	wikicat_Alumni_of_the_University_of_Bristol	299	627	-328	-1.0969899665551839
Sérgio_Araújo	wikicat_Clube_de_Regatas_do_Flamengo_players	10	21	-11	-1.1
Christian_Callejas	wikicat_Expatriate_footballers_in_Malta	3144	6613	-3469	-1.1033715012722647
Fábio_Lima	wikicat_FC_Gloria_Buzău_players	37	78	-41	-1.1081081081081081
Charlie_Ide	wikicat_Grays_Athletic_F.C._players	27	57	-30	-1.1111111111111112
Antonio_Rizzolo	wikicat_Association_football_forwards	9	19	-10	-1.1111111111111112
Martin_Luther_King,_Jr.	wikicat_Nonviolence_advocates	175	371	-196	-1.12
Voltaire	wikicat_Deists	431	914	-483	-1.1206496519721578
Zlatan_Ibrahimović	wikicat_Malmö_FF_players	8	17	-9	-1.125
Raf_de_Gregorio	wikicat_2003_FIFA_Confederations_Cup_players	32	68	-36	-1.125
Ravi_Shankar	wikicat_Indian_composers	8	17	-9	-1.125
Persija_Jakarta	wikicat_Association_football_clubs_established_in_1928	175	372	-197	-1.1257142857142857
Jeremy_Bentham	wikicat_British_activists	339	723	-384	-1.1327433628318584
Daisuke_Matsui	wikicat_Ligue_2_players	21	45	-24	-1.1428571428571428
Seymour_Benzer	wikicat_Purdue_University_alumni	3202	6875	-3673	-1.1470955652717052
Oran	wikicat_Port_cities	20	43	-23	-1.15
Spennymoor_United_F.C.	wikicat_Football_clubs_in_County_Durham	1699	3657	-1958	-1.1524426133019423
Pasteur_Institute	wikicat_Research_institutes_in_France	13	28	-15	-1.1538461538461537
Mauro_Bressan	wikicat_A.C._Milan_players	19	41	-22	-1.1578947368421053
Chris_de_Burgh	wikicat_Irish_pop_singers	143	309	-166	-1.1608391608391608
Zygmunt_Bauman	wikicat_Marxist_theorists	43	93	-50	-1.1627906976744187
Francis_Bacon	wikicat_17th-century_Latin-language_writers	207	448	-241	-1.1642512077294687
Anjelica_Huston	wikicat_American_people_of_British_descent	6	13	-7	-1.1666666666666667
Charles_Darwin	wikicat_Science_writers	54	117	-63	-1.1666666666666667
Insurgency_in_Northeast_India	wikicat_Conflicts_in_2013	12	26	-14	-1.1666666666666667
Kurniawan_Dwi_Yulianto	wikicat_2000_AFC_Asian_Cup_players	12	26	-14	-1.1666666666666667
Mvondo_Atangana	wikicat_FC_Luch-Energiya_Vladivostok_players	391	848	-457	-1.1687979539641944
Marcel_Domingo	wikicat_French_people_of_Spanish_descent	53	115	-62	-1.169811320754717
Édison_Méndez	wikicat_Clube_Atlético_Mineiro_players	281	611	-330	-1.1743772241992882
John_von_Neumann	wikicat_Hungarian_emigrants_to_the_United_States	17	37	-20	-1.1764705882352942
Roger_Hodgson	wikicat_English_expatriates_in_the_United_States	45	98	-53	-1.1777777777777778
Columbus,_Ohio	wikicat_Planned_cities_in_the_United_States	179	390	-211	-1.1787709497206704
Louis_XV_of_France	wikicat_People_from_Versailles	2140	4684	-2544	-1.188785046728972
Marcin_Folc	wikicat_Widzew_Łódź_players	1156	2531	-1375	-1.189446366782007
Queens	wikicat_Boroughs_of_New_York_City	26	57	-31	-1.1923076923076923
John_Maynard_Keynes	wikicat_LGBT_people_from_England	519	1138	-619	-1.1926782273603083
Karl_Marx	wikicat_People_from_the_Rhine_Province	143	314	-171	-1.1958041958041958
Tampico	wikicat_Populated_coastal_places_in_Mexico	7575	16643	-9068	-1.1970957095709571
Migen_Memelli	wikicat_Association_football_forwards	5	11	-6	-1.2
Michel_de_Montaigne	wikicat_Roman_Catholic_writers	15	33	-18	-1.2
Johnny_Carson	wikicat_United_States_Navy_officers	167	368	-201	-1.2035928143712575
Alice_Cooper	wikicat_American_rock_musicians	39	86	-47	-1.205128205128205
Dick_Cheney	wikicat_American_people_of_French_descent	82	181	-99	-1.2073170731707317
José_Veiga	wikicat_Estrela_da_Amadora_players	14	31	-17	-1.2142857142857142
Shaanxi	wikicat_Regions_of_China	364	807	-443	-1.217032967032967
Pula_Airport	wikicat_Airports_in_Croatia	9	20	-11	-1.2222222222222223
Gene_Kelly	wikicat_American_musical_theatre_actors	49	109	-60	-1.2244897959183674
Los_Cabos_International_Airport	wikicat_Airports_in_Mexico	65	145	-80	-1.2307692307692308
Diego_Serna	wikicat_New_England_Revolution_players	67	150	-83	-1.2388059701492538
Nicolae_Iorga	wikicat_Literary_critics	381	853	-472	-1.2388451443569555
Ikechi_Anya	wikicat_Sevilla_Atlético_footballers	1701	3811	-2110	-1.2404467960023515
Berkshire	wikicat_Ceremonial_counties	8	18	-10	-1.25
Walter_Benjamin	wikicat_Jewish_philosophers	8	18	-10	-1.25
Ger_Rowe	wikicat_Shelbourne_F.C._players	8	18	-10	-1.25
Alexandria	wikicat_Ports_and_harbours	4	9	-5	-1.25
Romy_Schneider	wikicat_French_film_actresses	4	9	-5	-1.25
Armand_Traoré	wikicat_AS_Monaco_FC_players	83	187	-104	-1.2530120481927711
Michael_Black_(footballer)	wikicat_Cheshunt_F.C._players	592	1336	-744	-1.2567567567567568
Thomas_Mann	wikicat_German-language_writers	31	70	-39	-1.2580645161290323
Maldives	wikicat_States_and_territories_established_in_1965	50	113	-63	-1.26
Kalusha_Bwalya	wikicat_Cercle_Brugge_K.S.V._players	109	247	-138	-1.2660550458715596
Washington,_D.C.	wikicat_Southern_United_States	3897	8832	-4935	-1.2663587374903773
Sheffield	wikicat_Post_towns_in_the_S_postcode_area	15	34	-19	-1.2666666666666666
Elbląg_County	wikicat_Counties_of_Poland	41	93	-52	-1.2682926829268293
Javier_Moro_León	wikicat_Lorca_Deportiva_footballers	11	25	-14	-1.2727272727272727
Wolfgang_Frank	wikicat_Rot-Weiss_Essen_managers	11	25	-14	-1.2727272727272727
Leonid_Hurwicz	wikicat_American_people_of_Polish-Jewish_descent	112	255	-143	-1.2767857142857142
Europe	wikicat_Peninsulas_of_Asia	7138	16252	-9114	-1.2768282432053797
Dean_Gordon	wikicat_Grimsby_Town_F.C._players	14	32	-18	-1.2857142857142858
Collins_John	wikicat_Piast_Gliwice_players	869	1996	-1127	-1.2968929804372842
Concord_Rangers_F.C.	wikicat_Association_football_clubs_established_in_1967	802	1844	-1042	-1.2992518703241895
Ruth_Rendell	wikicat_Women_mystery_writers	719	1655	-936	-1.301808066759388
Jean-Paul_Sartre	wikicat_Psychedelic_drug_advocates	92	213	-121	-1.315217391304348
John_Grisham	wikicat_Bancarella_Prize_winners	5957	13804	-7847	-1.3172737955346652
Gene_Wilder	wikicat_Diarists	283	656	-373	-1.3180212014134276
Nenad_Stojanović	wikicat_FK_Vojvodina_players	28	65	-37	-1.3214285714285714
Jean-Emmanuel_Effa_Owona	wikicat_US_Créteil-Lusitanos_players	221	514	-293	-1.3257918552036199
Partizani_Tirana	wikicat_Football_clubs_in_Albania	2719	6337	-3618	-1.3306362633321074
Theo_Lucius	wikicat_Dutch_footballers	3	7	-4	-1.3333333333333333
Moss_Airport,_Rygge	wikicat_Airports_in_Norway	6	14	-8	-1.3333333333333333
David_Lynch	wikicat_American_television_actors	3	7	-4	-1.3333333333333333
Teemu_Pukki	wikicat_Expatriate_footballers_in_Spain	3	7	-4	-1.3333333333333333
Franz_Carr	wikicat_Blackburn_Rovers_F.C._players	3	7	-4	-1.3333333333333333
Tottenham_Hotspur_F.C.	wikicat_Southern_Football_League_clubs	3	7	-4	-1.3333333333333333
Sani_Kaita	wikicat_Olympic_medalists_in_football	3	7	-4	-1.3333333333333333
Keith_Scott_(footballer)	wikicat_Tamworth_F.C._players	27	63	-36	-1.3333333333333333
Nicolas_Anelka	wikicat_French_expatriate_footballers	3	7	-4	-1.3333333333333333
Jimmy_McGeough,_Jr.	wikicat_National_Professional_Soccer_League_(1984–2001)_players	3	7	-4	-1.3333333333333333
Ronald_Reagan	wikicat_American_television_actors	3	7	-4	-1.3333333333333333
Mounir_El_Hamdaoui	wikicat_Expatriate_footballers_in_England	3	7	-4	-1.3333333333333333
George_Santayana	wikicat_Alumni_of_the_University_of_Cambridge	3	7	-4	-1.3333333333333333
Kim_Dae-eui	wikicat_South_Korean_expatriate_footballers	3	7	-4	-1.3333333333333333
Colchester_(England)	wordnet_site_108651247	3	7	-4	-1.3333333333333333
Windhoek	wikicat_Populated_places_established_in_1890	5687	13369	-7682	-1.3508000703358538
Vyacheslav_Sviderskyi	wikicat_2006_FIFA_World_Cup_players	162	381	-219	-1.3518518518518519
Ashley_Vickers	wikicat_Association_football_defenders	51	120	-69	-1.3529411764705883
Argentinos_Juniors	wikicat_Association_football_clubs_established_in_1904	358	845	-487	-1.3603351955307263
Cédric_Roussel	wikicat_Walloon_people	99	234	-135	-1.3636363636363635
New_Haven	wikicat_Cities_in_the_United_States	27	64	-37	-1.3703703703703705
FK_Radnički_Niš	wikicat_Football_clubs_in_Serbia	16	38	-22	-1.375
Eric_Idle	wikicat_British_singers	16	38	-22	-1.375
Herby_Fortunat	wikicat_France_youth_international_footballers	8	19	-11	-1.375
Vladimir_Vasilj	wikicat_NK_Široki_Brijeg_players	8	19	-11	-1.375
Niels_Bohr	wikicat_Jewish_atheists	77	183	-106	-1.3766233766233766
Michel_Aflaq	wikicat_Arab_politicians	153	364	-211	-1.3790849673202614
Louie_Donowa	wikicat_Expatriate_footballers_in_Finland	442	1052	-610	-1.3800904977375565
Hawaii	wikicat_Western_United_States	13	31	-18	-1.3846153846153846
John_Kerry	wikicat_American_lawyers	18	43	-25	-1.3888888888888888
John_Cassavetes	wikicat_Film_directors_from_New_York_City	122	292	-170	-1.3934426229508197
A.S._Livorno_Calcio	wikicat_Association_football_clubs_established_in_1915	4391	10516	-6125	-1.3948986563425188
Senthil_(actor)	wikicat_Actors_in_Tamil_cinema	10	24	-14	-1.4
Geoffrey_Castillion	wikicat_AFC_Ajax_players	35	84	-49	-1.4
Amy_Irving	wikicat_Actresses_from_New_York_City	5	12	-7	-1.4
Robert_Anton_Wilson	wikicat_American_anarchists	67	161	-94	-1.4029850746268657
Dan_Aykroyd	wikicat_Male_actors_from_Ottawa	163	393	-230	-1.4110429447852761
Ebbw_Vale_F.C.	wikicat_Association_football_clubs_established_in_1888	46	111	-65	-1.4130434782608696
Martin_Heidegger	wikicat_German_poets	352	850	-498	-1.4147727272727273
Louisville	wikicat_Cities_in_the_United_States	5016	12151	-7135	-1.4224481658692185
Jerry_Siegel	wikicat_Science_fiction_fans	137	332	-195	-1.4233576642335766
Romy_Schneider	wikicat_20th-century_actresses	35	85	-50	-1.4285714285714286
Dominique_de_Villepin	wikicat_Panthéon-Assas_University_alumni	7	17	-10	-1.4285714285714286
Fathi_Chebal	wikicat_Algerian_expatriates_in_Saudi_Arabia	5649	13746	-8097	-1.4333510355815189
Agustín_Castillo	wikicat_Deportivo_Cuenca_footballers	1329	3234	-1905	-1.4334085778781038
Karl_Marx	wikicat_English_revolutionaries	91	222	-131	-1.4395604395604396
Jean-Paul_Sartre	wikicat_Contemporary_philosophers	9	22	-13	-1.4444444444444444
Clube_Náutico_Capibaribe	wikicat_Football_clubs_in_Brazil	9	22	-13	-1.4444444444444444
Riza_Lushta	wikicat_A.S._Bari_players	29	71	-42	-1.4482758620689655
Kim_Nam-il	wikicat_2002_CONCACAF_Gold_Cup_players	97	238	-141	-1.4536082474226804
Mark_Fotheringham	wikicat_Notts_County_F.C._players	163	400	-237	-1.4539877300613497
Albert_Camus	wikicat_Anarchists	24	59	-35	-1.4583333333333333
Paul_Gerrard	wikicat_Everton_F.C._players	32	79	-47	-1.46875
Don_Winslow	wikicat_People_from_New_York_City	17	42	-25	-1.4705882352941178
Gustav_Kirchhoff	wikicat_19th-century_German_people	53	131	-78	-1.471698113207547
John_Huston	wikicat_American_people_of_Welsh_descent	19	47	-28	-1.4736842105263157
Dune_(film)	wikicat_Space_adventure_films	21	52	-31	-1.4761904761904763
Nicolae_Simatoc	wikicat_Brescia_Calcio_players	39	97	-58	-1.4871794871794872
Enköping_Municipality	wikicat_Municipalities_of_Uppsala_County	6583	16378	-9795	-1.4879234391614766
George_Oghani	wikicat_Bury_F.C._players	47	117	-70	-1.4893617021276595
Chakhir_Belghazouani	wikicat_Expatriate_footballers_in_Ukraine	168	419	-251	-1.494047619047619
PH_postcode_area	wordnet_area_108497294	40	100	-60	-1.5
Julio_Cortázar	wikicat_People_from_Paris	2	5	-3	-1.5
John_F._Kennedy	wikicat_Cold_War_leaders	22	55	-33	-1.5
Blackpool_F.C.	wikicat_Football_clubs_in_Lancashire	28	70	-42	-1.5
Tony_Dinning	wikicat_Walsall_F.C._players	2	5	-3	-1.5
Clube_Recreativo_e_Atlético_Catalano	wordnet_club_108227214	14	35	-21	-1.5
Gottlob_Frege	wikicat_20th-century_philosophers	2	5	-3	-1.5
Ikechi_Anya	wikicat_Scottish_expatriates_in_Spain	2	5	-3	-1.5
Roger_Hodgson	wikicat_English_songwriters	2	5	-3	-1.5
Maceió	wikicat_State_capitals_in_Brazil	2	5	-3	-1.5
Alicia_Silverstone	wikicat_American_stage_actors	2	5	-3	-1.5
Morocco	wikicat_Countries_in_Africa	2	5	-3	-1.5
Nélson_Marcos	wikicat_Serie_A_footballers	2	5	-3	-1.5
Lenny_Kravitz	wikicat_21st-century_American_male_actors	2	5	-3	-1.5
Abraham_Lincoln	wikicat_Smallpox_survivors	2818	7045	-4227	-1.5
Ivor_Novello_Awards	wikicat_Music_awards	2	5	-3	-1.5
Kostyantyn_Panin	wikicat_FC_Chornomorets_Odessa_players	4	10	-6	-1.5
Marcel_Domingo	wikicat_Nîmes_Olympique_managers	2	5	-3	-1.5
Neuilly-sur-Seine	wikicat_Communes_of_Hauts-de-Seine	4	10	-6	-1.5
Boz_Scaggs	wikicat_American_guitarists	2	5	-3	-1.5
Riga_Mustapha	wikicat_Dutch_footballers	6	15	-9	-1.5
Sigmund_Freud	wikicat_Jewish_scientists	2	5	-3	-1.5
Al_Hazm_(football_club)	wordnet_club_108227214	2	5	-3	-1.5
Héverton_Durães_Coutinho_Alves	wikicat_Brazilian_expatriates_in_South_Korea	2	5	-3	-1.5
Jean-Emmanuel_Effa_Owona	wikicat_Terengganu_FA_players	2	5	-3	-1.5
Paulo_Sérgio_Moreira_Gonçalves	wikicat_Estrela_da_Amadora_players	8	20	-12	-1.5
Peter_Fonda	wikicat_Actors_from_New_York	2	5	-3	-1.5
Kronstadt	wikicat_Cities_of_Military_Glory	2	5	-3	-1.5
Eritrean_War_of_Independence	wikicat_Wars_involving_Cuba	6	15	-9	-1.5
Mark_Prudhoe	wikicat_Doncaster_Rovers_F.C._players	71	178	-107	-1.5070422535211268
Jack_Black	wikicat_Jewish_American_writers	70	176	-106	-1.5142857142857142
Osnabrück	wikicat_Populated_places_established_in_the_8th_century	23	58	-35	-1.5217391304347827
Ljubiša_Stevanović	wikicat_Yugoslavia_international_footballers	21	53	-32	-1.5238095238095237
Richmondshire	wordnet_administrative_district_108491826	19	48	-29	-1.5263157894736843
Thom_Yorke	wikicat_English_activists	978	2475	-1497	-1.530674846625767
Amartya_Sen	wikicat_Male_feminists	160	405	-245	-1.53125
Christopher_Hitchens	wikicat_American_people_of_Polish-Jewish_descent	153	388	-235	-1.5359477124183007
Rani_Mukerji	wikicat_Women	13	33	-20	-1.5384615384615385
Danny_Califf	wikicat_LA_Galaxy_players	11	28	-17	-1.5454545454545454
B._W._Powe	wikicat_Writers_from_Toronto	781	1988	-1207	-1.5454545454545454
Moussa_N'Diaye	wikicat_Senegalese_footballers	159	405	-246	-1.5471698113207548
Claudette_Colbert	wikicat_Kennedy_Center_honorees	91	232	-141	-1.5494505494505495
LNB_Pro_A	wordnet_league_108231184	3442	8802	-5360	-1.557234166182452
Club_Atlético_Sarmiento	wikicat_Association_football_clubs_established_in_1911	1825	4669	-2844	-1.5583561643835617
Matías_Urbano	wikicat_San_Lorenzo_footballers	23	59	-36	-1.565217391304348
Don_DeLillo	wikicat_Guggenheim_Fellows	7	18	-11	-1.5714285714285714
Stephen_Fry	wikicat_British_comedians	14	36	-22	-1.5714285714285714
Franz_Carr	wikicat_English_expatriates_in_the_United_States	313	805	-492	-1.571884984025559
Ilkeston_F.C.	wikicat_Football_clubs_in_Derbyshire	432	1112	-680	-1.5740740740740742
Rolando_Escobar	wikicat_Panamanian_expatriate_footballers	27	70	-43	-1.5925925925925926
Emre_Belözoğlu	wikicat_Footballers_from_Istanbul	27	70	-43	-1.5925925925925926
Cat_Power	wikicat_Musicians_from_Georgia_(U.S._state)	239	620	-381	-1.594142259414226
Roald_Dahl	wikicat_British_people_of_World_War_II	580	1505	-925	-1.5948275862068966
Roque_Santa_Cruz	wikicat_Expatriate_footballers_in_Germany	10	26	-16	-1.6
Alex_Revell	wikicat_Rotherham_United_F.C._players	5	13	-8	-1.6
Sarah_Jessica_Parker	wikicat_Actors_from_Ohio	175	455	-280	-1.6
Kyzylorda_Province	wordnet_administrative_district_108491826	5	13	-8	-1.6
Joyce_Carol_Oates	wikicat_American_dramatists_and_playwrights	20	52	-32	-1.6
Carlos_Gamarra	wikicat_Olympic_silver_medalists_for_Paraguay	232	608	-376	-1.6206896551724137
Milton_Friedman	wikicat_People_from_Brooklyn	16	42	-26	-1.625
Klaus_Toppmöller	wikicat_Eintracht_Frankfurt_managers	11	29	-18	-1.6363636363636365
Mircea_Eliade	wikicat_Christian_writers	219	579	-360	-1.643835616438356
Milton_Friedman	wikicat_Jewish_agnostics	3	8	-5	-1.6666666666666667
IEEE_Edison_Medal	wikicat_Academic_awards	15	40	-25	-1.6666666666666667
Lisbon_Portela_Airport	wikicat_Airports_in_Portugal	6	16	-10	-1.6666666666666667
Albert_Einstein	wikicat_Agnostics	3	8	-5	-1.6666666666666667
Lárus_Guðmundsson	wikicat_Expatriate_footballers_in_Germany	3	8	-5	-1.6666666666666667
Mario_Bolatti	wikicat_Campeonato_Brasileiro_Série_A_footballers	3	8	-5	-1.6666666666666667
Steven_Spielberg	wikicat_Screenwriters	3	8	-5	-1.6666666666666667
Karl_Marx	wikicat_English_philosophers	19	51	-32	-1.6842105263157894
Memphis,_Tennessee	wikicat_Planned_cities_in_the_United_States	86	231	-145	-1.686046511627907
Eltinho	wikicat_Campeonato_Brasileiro_Série_A_footballers	7	19	-12	-1.7142857142857142
Henry_Adams	wikicat_People_from_Boston,_Massachusetts	14	38	-24	-1.7142857142857142
Bradley_Thomas_(footballer)	wikicat_Braintree_Town_F.C._players	120	326	-206	-1.7166666666666666
Nana_Falemi	wikicat_FC_Volyn_Lutsk_players	83	226	-143	-1.7228915662650603
Richard_Barthelmess	wikicat_People_from_Long_Island	66	180	-114	-1.7272727272727273
Aldo_Adorno	wikicat_UD_Almería_footballers	136	371	-235	-1.7279411764705883
Peter_Debye	wikicat_Physical_chemists	26	71	-45	-1.7307692307692308
Giovane_Élber	wikicat_Expatriate_footballers_in_Italy	19	52	-33	-1.736842105263158
FC_Barcelona_C	wikicat_Association_football_clubs_disestablished_in_2007	428	1172	-744	-1.7383177570093458
Central_Europe	wikicat_Regions	5620	15419	-9799	-1.743594306049822
Alexandria_(Virginia)	wikicat_Cities_in_the_United_States	8	22	-14	-1.75
Andrew_V._McLaglen	wikicat_Western_(genre)_film_directors	12	33	-21	-1.75
Brendan_Fraser	wikicat_Canadian_voice_actors	8	22	-14	-1.75
Rachel_Weisz	wikicat_Jewish_actors	8	22	-14	-1.75
C.A._River_Plate	wordnet_club_108227214	4	11	-7	-1.75
Daniel_Prodan	wikicat_FC_Steaua_București_players	4	11	-7	-1.75
Emmanuel_Levinas	wikicat_Existentialists	4	11	-7	-1.75
América_Futebol_Clube_(SP)	wikicat_Football_clubs_in_São_Paulo_(state)	4	11	-7	-1.75
José_Carlos_da_Costa_Araújo	wikicat_Americano_Futebol_Clube_players	356	980	-624	-1.752808988764045
Kansas	wikicat_States_and_territories_established_in_1861	1691	4656	-2965	-1.7534003548196333
Leudal	wikicat_Cities_in_the_Netherlands	13	36	-23	-1.7692307692307692
Ljubljana	wikicat_Capitals_in_Europe	80	222	-142	-1.775
Steven_Spielberg	wikicat_BAFTA_fellows	249	692	-443	-1.7791164658634537
Wheeling,_West_Virginia	wikicat_Former_United_States_state_capitals	159	444	-285	-1.7924528301886793
Henry_Jaglom	wikicat_American_dramatists_and_playwrights	69	193	-124	-1.7971014492753623
Clonmel	wikicat_Towns_and_villages_in_County_Tipperary	198	554	-356	-1.797979797979798
Deutschlandsberg_District	wikicat_Districts_of_Styria	5	14	-9	-1.8
Bruno_Pereirinha	wikicat_S.S._Lazio_players	10	28	-18	-1.8
Carlos_Gamarra	wikicat_S.L._Benfica_footballers	5	14	-9	-1.8
Kelvin_Jack	wikicat_Association_football_goalkeepers	5	14	-9	-1.8
Allen_Ginsberg	wikicat_Jewish_anarchists	6	17	-11	-1.8333333333333333
David_Martin_(footballer_born_1986)	wikicat_Wimbledon_F.C._players	60	171	-111	-1.85
Peter_Hynes	wikicat_Shelbourne_F.C._players	7	20	-13	-1.8571428571428572
Colin_Firth	wikicat_People_from_Hampshire	7	20	-13	-1.8571428571428572
Ludwig_von_Mises	wikicat_Libertarian_theorists	151	432	-281	-1.8609271523178808
Nikos_Barboudis	wikicat_Apollon_Kalamarias_F.C._players	29	83	-54	-1.8620689655172413
Garry_Thompson_(footballer_born_1959)	wikicat_Brentford_F.C._managers	327	936	-609	-1.8623853211009174
Friedrich_Hayek	wikicat_20th-century_philosophers	9	26	-17	-1.8888888888888888
Ville_Väisänen	wikicat_FC_Jazz_Pori_players	9	26	-17	-1.8888888888888888
Kalloni_F.C.	wikicat_Association_football_clubs_established_in_1994	188	544	-356	-1.8936170212765957
J._R._Bremer	wikicat_Fenerbahçe_men's_basketball_players	38	110	-72	-1.894736842105263
Cardiff_City_F.C.	wikicat_Former_Football_League_clubs	10	29	-19	-1.9
Agnaldo_Cordeiro_Pereira	wikicat_Brasiliense_Futebol_Clube_players	44	128	-84	-1.9090909090909092
Keith_Jarrett	wikicat_Hard_bop_pianists	56	163	-107	-1.9107142857142858
Ahmed_Deen	wikicat_Bishop's_Stortford_F.C._players	36	105	-69	-1.9166666666666667
Vyškov	wordnet_administrative_district_108491826	13	38	-25	-1.9230769230769231
Iván_Guerrero	wikicat_Coventry_City_F.C._players	272	797	-525	-1.9301470588235294
Santiago_Cañizares	wikicat_People_from_Madrid	81	238	-157	-1.9382716049382716
Aleksinac	wordnet_administrative_district_108491826	17	50	-33	-1.9411764705882353
J._Robert_Oppenheimer	wikicat_Weapons_scientists_and_engineers	235	692	-457	-1.9446808510638298
Jean-Emmanuel_Effa_Owona	wikicat_MKE_Ankaragücü_footballers	24	71	-47	-1.9583333333333333
Anselmo_Ramon	wikicat_Brazilian_expatriates_in_China	25	74	-49	-1.96
Daniel_McBreen	wikicat_Shanghai_East_Asia_players	946	2827	-1881	-1.9883720930232558
Werner_Heisenberg	wikicat_People_from_Bavaria	408	1221	-813	-1.9926470588235294
Fábio_Bilica	wikicat_Expatriate_footballers_in_Italy	1	3	-2	-2.0
Trinidad	wordnet_island_109316454	1	3	-2	-2.0
Jade_North	wikicat_J._League_Division_1_players	1	3	-2	-2.0
Oliver_Ryan	wikicat_Northwich_Victoria_F.C._players	5	15	-10	-2.0
Benjamin_Fondane	wikicat_Surrealist_poets	1	3	-2	-2.0
Vadsø_Airport	wordnet_airport_102692232	1	3	-2	-2.0
Pierce_Brosnan	wikicat_Irish_male_film_actors	1	3	-2	-2.0
Matt_Dillon	wikicat_21st-century_American_male_actors	1	3	-2	-2.0
Sandro_Calabro	wikicat_Dutch_footballers	3	9	-6	-2.0
Richard_Duffy	wikicat_Swansea_City_A.F.C._players	1	3	-2	-2.0
Kashmir_Valley	wikicat_Subdivisions_of_Pakistan	1	3	-2	-2.0
Washoe_County,_Nevada	wordnet_county_108546183	3	9	-6	-2.0
Sergio_Volpi	wikicat_Reggina_Calcio_players	5	15	-10	-2.0
Dennis_Lehane	wikicat_American_crime_fiction_writers	5	15	-10	-2.0
Dessau	wikicat_Cities_in_Saxony-Anhalt	1	3	-2	-2.0
Donald_Crisp	wikicat_English_film_directors	1	3	-2	-2.0
John_McCain	wikicat_Republican_Party_(United_States)_politicians	10	30	-20	-2.0
Gene_Wilder	wikicat_American_comedians	1	3	-2	-2.0
Wassily_Leontief	wikicat_American_academics	1	3	-2	-2.0
Fernando_Meira	wikicat_Russian_Premier_League_players	1	3	-2	-2.0
Modeste_M'bami	wikicat_2003_FIFA_Confederations_Cup_players	1	3	-2	-2.0
Gary_Moore	wikicat_British_rock_musicians	1	3	-2	-2.0
Aldo_Adorno	wikicat_Expatriate_footballers_in_Israel	1	3	-2	-2.0
Belfast	wikicat_County_towns_in_the_Republic_of_Ireland	13	39	-26	-2.0
Anthony_Whelan	wikicat_Bohemian_F.C._players	1	3	-2	-2.0
Frédéric_Bastiat	wikicat_19th-century_economists	19	57	-38	-2.0
Osnabrück	wikicat_Cities_in_Lower_Saxony	1	3	-2	-2.0
Alan_Dodd_(English_footballer)	wikicat_Stoke_City_F.C._players	1	3	-2	-2.0
Flannery_O'Connor	wikicat_American_women_writers	3	9	-6	-2.0
Walter_Benjamin	wikicat_Political_philosophers	7	21	-14	-2.0
England	wikicat_Germanic_countries_and_territories	54	162	-108	-2.0
Alexander_R._Todd,_Baron_Todd	wikicat_Nobel_laureates_in_Chemistry	2	6	-4	-2.0
Nick_McKoy	wikicat_Scottish_Football_League_players	2	6	-4	-2.0
Ludwig_von_Mises	wikicat_Jewish_American_writers	1	3	-2	-2.0
Dwight_D._Eisenhower	wikicat_American_people_of_British_descent	2	6	-4	-2.0
Curly_Howard	wikicat_American_stage_actors	2	6	-4	-2.0
Vitória_S.C.	wikicat_Football_clubs_in_Portugal	2	6	-4	-2.0
Liza_Minnelli	wikicat_American_people_of_Italian_descent	4	12	-8	-2.0
Sergio_Romero	wikicat_Olympic_medalists_in_football	2	6	-4	-2.0
Vannevar_Bush	wikicat_Tufts_University_alumni	1	3	-2	-2.0
Cosenza_Calcio	wikicat_Serie_B_clubs	1	3	-2	-2.0
Charles_University_in_Prague	wikicat_Educational_institutions_established_in_the_14th_century	1	3	-2	-2.0
Kim_Christensen_(footballer_born_1980)	wikicat_Brøndby_IF_players	4	12	-8	-2.0
North_Korea	wikicat_Divided_regions	2	6	-4	-2.0
FC_Shakhtar_Donetsk	wikicat_Football_clubs_in_Ukraine	1	3	-2	-2.0
Helensburgh	wordnet_site_108651247	1	3	-2	-2.0
Order_of_Liberty	wikicat_Orders_of_knighthood_awarded_to_heads_of_state,_consorts_and_sovereign_family_members	1	3	-2	-2.0
United_States	wikicat_Countries	1	3	-2	-2.0
Multan_District	wikicat_Districts_of_Punjab,_Pakistan	1	3	-2	-2.0
Christopher_Reeve	wikicat_21st-century_American_male_actors	1	3	-2	-2.0
Ninoslav_Milenković	wikicat_Expatriate_footballers_in_Germany	4	12	-8	-2.0
Delhi	wordnet_administrative_district_108491826	1	3	-2	-2.0
İbrahim_Kaş	wikicat_Turkey_international_footballers	2	6	-4	-2.0
Apocalypse_Now	wikicat_Miramax_Films_films	2	6	-4	-2.0
Gümüşhane_Province	wordnet_administrative_district_108491826	1	3	-2	-2.0
Poole	wikicat_Local_government_districts_of_South_West_England	4	12	-8	-2.0
Ludwig_Wittgenstein	wikicat_Philosophers_of_mind	2	6	-4	-2.0
Eastern_AA	wikicat_Football_clubs_in_Hong_Kong	1	3	-2	-2.0
Rodney_Bush	wikicat_Expatriate_footballers_in_Scotland	1	3	-2	-2.0
Südliches_Anhalt	wikicat_Towns_in_Saxony-Anhalt	2	6	-4	-2.0
Alan_McLoughlin	wikicat_Forest_Green_Rovers_F.C._players	603	1810	-1207	-2.001658374792703
John_Huston	wikicat_American_people_of_Scotch-Irish_descent	146	440	-294	-2.0136986301369864
Bert_Bates	wikicat_British_film_editors	150	453	-303	-2.02
Sergio_Romero	wikicat_Italian_people	3667	11091	-7424	-2.0245432233433323
Ronald_Reagan	wikicat_People_of_the_Soviet_war_in_Afghanistan	312	950	-638	-2.0448717948717947
Chhunly_Pagenburg	wikicat_1._FC_Nürnberg_II_players	128	391	-263	-2.0546875
Zlatan_Ibrahimović	wikicat_AFC_Ajax_players	46	141	-95	-2.0652173913043477
Leeuwarden	wordnet_administrative_district_108491826	172	528	-356	-2.0697674418604652
Chick_Corea	wikicat_People_from_Massachusetts	1909	5865	-3956	-2.072289156626506
Eduardo_Gonçalves_de_Oliveira	wikicat_1._FSV_Mainz_05_players	192	590	-398	-2.0729166666666665
Viborg_FF	wordnet_club_108227214	13	40	-27	-2.076923076923077
Sékou_Berthé	wikicat_Tours_FC_players	177	551	-374	-2.1129943502824857
University_of_Graz	wikicat_Universities_and_colleges_in_Austria	148	463	-315	-2.1283783783783785
Shane_Huke	wikicat_People_from_Reading,_Berkshire	5461	17130	-11669	-2.1367881340413843
Monica_(singer)	wikicat_African-American_record_producers	7	22	-15	-2.142857142857143
Levan_Maghradze	wikicat_AEP_Paphos_players	20	63	-43	-2.15
Sergey_Kostyuk	wikicat_FC_Tobol_players	1025	3243	-2218	-2.1639024390243904
Damián_Manso	wikicat_Expatriate_footballers_in_Ecuador	61	193	-132	-2.1639344262295084
Doris_Lessing	wikicat_English_dramatists_and_playwrights	6	19	-13	-2.1666666666666665
Gheorghe_Hagi	wikicat_Süper_Lig_managers	424	1344	-920	-2.169811320754717
Hércules_CF	wikicat_Association_football_clubs_established_in_1922	137	437	-300	-2.18978102189781
Syracuse,_New_York	wikicat_Populated_places_established_in_1825	2698	8624	-5926	-2.19644180874722
Steven_Caldwell	wikicat_Birmingham_City_F.C._players	5	16	-11	-2.2
Ludwig_von_Bertalanffy	wikicat_Fellows_of_the_German_Academy_of_Sciences_Leopoldina	5	16	-11	-2.2
K.V.C._Westerlo	wikicat_Association_football_clubs_established_in_1933	210	673	-463	-2.204761904761905
Giuseppe_Verdi	wikicat_Italian_atheists	211	677	-466	-2.2085308056872037
Antonio_Rizzolo	wikicat_Segunda_División_footballers	38	122	-84	-2.210526315789474
Jermain_Defoe	wikicat_England_B_international_footballers	27	87	-60	-2.2222222222222223
Stefano_Borgonovo	wikicat_Brescia_Calcio_players	9	29	-20	-2.2222222222222223
University_of_Marburg	wordnet_university_108286569	9	29	-20	-2.2222222222222223
Erwin_Schrödinger	wikicat_Alumni_of_Magdalen_College,_Oxford	451	1455	-1004	-2.2261640798226163
André_Luiz_Moreira	wikicat_Footballers_at_the_1996_Summer_Olympics	146	473	-327	-2.23972602739726
Jimmy_Oliver	wikicat_ABA_League_players	61	198	-137	-2.2459016393442623
Albert_Camus	wikicat_Modernist_writers	16	52	-36	-2.25
Wellington_Gonçalves_Amorim	wikicat_América_Futebol_Clube_(MG)_players	8	26	-18	-2.25
Wolverhampton	wikicat_Metropolitan_boroughs	4	13	-9	-2.25
Reba_McEntire	wikicat_American_female_country_singers	51	166	-115	-2.2549019607843137
Ludwig_von_Mises	wikicat_Jewish_philosophers	15	49	-34	-2.2666666666666666
Thomas_Jefferson	wikicat_Classical_liberals	75	246	-171	-2.28
Leipzig	wikicat_Cities_in_Saxony	17	56	-39	-2.2941176470588234
Daniel_McBreen	wikicat_FC_Universitatea_Craiova_players	779	2571	-1792	-2.300385109114249
Michael_Lamey	wikicat_PSV_Eindhoven_players	13	43	-30	-2.3076923076923075
Spennymoor_United_F.C.	wikicat_Defunct_football_clubs_in_England	3	10	-7	-2.3333333333333335
Roque_Santa_Cruz	wikicat_Club_Olimpia_footballers	6	20	-14	-2.3333333333333335
Grand_Duke_Konstantin_Nikolayevich_of_Russia	wordnet_person_100007846	45	150	-105	-2.3333333333333335
Roscoe_Arbuckle	wikicat_Vaudeville_performers	3	10	-7	-2.3333333333333335
Bridgend	wikicat_Post_towns_in_the_CF_postcode_area	6	20	-14	-2.3333333333333335
Samir_Boughanem	wikicat_Shamrock_Rovers_F.C._players	606	2026	-1420	-2.3432343234323434
Gheorghe_Hagi	wikicat_Expatriate_football_managers_in_Turkey	1109	3711	-2602	-2.3462578899909827
Martin_Woods	wikicat_Sunderland_A.F.C._players	11	37	-26	-2.3636363636363638
Toshiko_Akiyoshi	wikicat_Hard_bop_pianists	77	260	-183	-2.3766233766233764
Thiago_Maciel	wikicat_Betim_Esporte_Clube_players	54	183	-129	-2.388888888888889
Éder_Aleixo_de_Assis	wikicat_1982_FIFA_World_Cup_players	130	441	-311	-2.3923076923076922
George_Carlin	wikicat_American_non-fiction_writers	66	224	-158	-2.393939393939394
Pascal_Zuberbühler	wikicat_UEFA_Euro_2004_players	5	17	-12	-2.4
Rincón_(footballer_born_1987)	wikicat_Sporting_Clube_de_Portugal_footballers	5	17	-12	-2.4
Beitar_Jerusalem_F.C.	wikicat_Association_football_clubs_established_in_1939	361	1235	-874	-2.4210526315789473
Friedrich_Engels	wikicat_German_revolutionaries	35	120	-85	-2.4285714285714284
Dundee_United_F.C.	wikicat_United_Soccer_Association_imported_teams	7	24	-17	-2.4285714285714284
Zürich	wikicat_Cantonal_capitals_of_Switzerland	7	24	-17	-2.4285714285714284
Sigfried_Held	wikicat_1970_FIFA_World_Cup_players	654	2249	-1595	-2.4388379204892967
FC_Istres	wikicat_Football_clubs_in_France	43	148	-105	-2.441860465116279
Charles_de_Gaulle	wikicat_Attempted_assassination_survivors	9	31	-22	-2.4444444444444446
John_Maynard_Keynes	wikicat_Liberal_Party_(UK)_politicians	477	1646	-1169	-2.450733752620545
Münster	wordnet_administrative_district_108491826	75	259	-184	-2.453333333333333
Mario_Yepes	wikicat_FC_Nantes_players	32	111	-79	-2.46875
Caylloma_Province	wikicat_Provinces_of_Peru	111	386	-275	-2.4774774774774775
Jennifer_Lopez	wikicat_Actresses_from_New_York_City	27	94	-67	-2.4814814814814814
Friedrich_Engels	wikicat_19th-century_Prussian_people	78	272	-194	-2.4871794871794872
Anthony_Eden	wikicat_Conservative_Party_(UK)_politicians	48	168	-120	-2.5
Cardiff	wikicat_Counties_of_Wales	2	7	-5	-2.5
Cumbria	wikicat_NUTS_2_statistical_regions_of_the_United_Kingdom	2	7	-5	-2.5
John_McAliskey	wikicat_Association_football_forwards	6	21	-15	-2.5
Édison_Méndez	wikicat_2014_FIFA_World_Cup_players	56	196	-140	-2.5
Charlie_Chaplin	wikicat_Vaudeville_performers	14	49	-35	-2.5
Cary,_North_Carolina	wordnet_administrative_district_108491826	4	14	-10	-2.5
United_States_Military_Academy_at_West_Point	wikicat_Military_academies_of_the_United_States	2	7	-5	-2.5
Olumuyiwa_Aganun	wikicat_Nigerian_people	2	7	-5	-2.5
Jean-François_Lyotard	wikicat_Historians_of_philosophy	2	7	-5	-2.5
Henri_Poincaré	wikicat_Logicians	32	112	-80	-2.5
Marvin_Minsky	wikicat_Jewish_atheists	2	7	-5	-2.5
Joshua_Jackson	wikicat_Canadian_male_child_actors	85	298	-213	-2.5058823529411764
Adolf_Hitler	wikicat_Stateless_people	115	404	-289	-2.5130434782608697
Andrey_Yeshchenko	wikicat_FC_Khimki_players	23	81	-58	-2.5217391304347827
Jusuf_Dajić	wikicat_Jeonbuk_Hyundai_Motors_players	36	127	-91	-2.5277777777777777
War_on_Terror	wikicat_Ongoing_conflicts	23	82	-59	-2.5652173913043477
Odessa	wikicat_Hero_Cities_of_the_Soviet_Union	37	133	-96	-2.5945945945945947
André_3000	wikicat_African-American_actors	5	18	-13	-2.6
Mario_Bolatti	wikicat_Sport_Club_Internacional_players	20	72	-52	-2.6
University_of_Freiburg	wordnet_university_108286569	30	108	-78	-2.6
Ilija_Najdoski	wikicat_Eastern_Romance_people	1034	3766	-2732	-2.642166344294004
Luis_Bacalov	wikicat_Living_people	14	51	-37	-2.642857142857143
University_of_Freiburg	wikicat_Educational_institutions_established_in_the_15th_century	57	208	-151	-2.6491228070175437
Bath_City_F.C.	wikicat_Southern_Football_League_clubs	6	22	-16	-2.6666666666666665
Yuri_Morales	wikicat_USL_First_Division_players	6	22	-16	-2.6666666666666665
Fernando_Machado	wikicat_Montevideo_Wanderers_F.C._players	15	55	-40	-2.6666666666666665
Inter_Milan	wikicat_Unrelegated_association_football_clubs	12	44	-32	-2.6666666666666665
New_York_City	wikicat_Cities_in_New_York	3	11	-8	-2.6666666666666665
Evando	wikicat_Santos_Futebol_Clube_players	15	55	-40	-2.6666666666666665
Anthony_Eden	wikicat_British_people_of_World_War_II	28	103	-75	-2.6785714285714284
Silviu_Izvoranu	wikicat_FC_Volyn_Lutsk_players	22	81	-59	-2.6818181818181817
Carl_Pentney	wikicat_Bath_City_F.C._players	16	59	-43	-2.6875
David_Seaman	wikicat_English_people	10	37	-27	-2.7
Louis_Pasteur	wikicat_French_Nobel_laureates	7	26	-19	-2.7142857142857144
Highland_Park,_Michigan	wikicat_Cities_in_Wayne_County,_Michigan	36	134	-98	-2.7222222222222223
Charleston_(South_Carolina)	wikicat_Cities_in_the_United_States	4	15	-11	-2.75
George_Best	wikicat_North_American_Soccer_League_(1968–84)_players	8	30	-22	-2.75
Charles_Darwin	wikicat_English_sceptics	220	827	-607	-2.7590909090909093
Emmanuel_Levinas	wikicat_Social_philosophers	17	64	-47	-2.764705882352941
Robert_Enke	wikicat_Fenerbahçe_footballers	19	72	-53	-2.789473684210526
Richard_Hofstadter	wikicat_Jewish_American_historians	287	1088	-801	-2.7909407665505226
Peter_Sarsgaard	wikicat_American_people_of_Danish_descent	44	167	-123	-2.7954545454545454
Worthing	wikicat_Post_towns_in_the_BN_postcode_area	10	38	-28	-2.8
Nizhny_Novgorod	wikicat_Populated_places_on_the_Volga	5	19	-14	-2.8
Mike_Pollitt	wikicat_Bury_F.C._players	32	122	-90	-2.8125
Ludwig_Wittgenstein	wikicat_Contemporary_philosophers	28	107	-79	-2.8214285714285716
Henri_Lefebvre	wikicat_Urban_theorists	109	417	-308	-2.8256880733944953
Praemium_Imperiale	wikicat_Arts_awards	6	23	-17	-2.8333333333333335
Sudan	wikicat_States_and_territories_established_in_1956	6	23	-17	-2.8333333333333335
Jimmy_Ghaichem	wikicat_Mansfield_Town_F.C._players	6	23	-17	-2.8333333333333335
Richard_O'Donnell	wikicat_Buxton_F.C._players	489	1881	-1392	-2.8466257668711656
Thom_Yorke	wikicat_Anti-globalization_activists	1607	6186	-4579	-2.849408836341008
Dimitrija_Lazarevski	wikicat_Association_football_defenders	7	27	-20	-2.857142857142857
Johann_Gottlieb_Fichte	wikicat_Political_philosophers	7	27	-20	-2.857142857142857
Pedro_León	wikicat_Real_Valladolid_footballers	8	31	-23	-2.875
Chevy_Chase,_Maryland	wordnet_administrative_district_108491826	282	1096	-814	-2.8865248226950353
Eysturoy	wordnet_island_109316454	9	35	-26	-2.888888888888889
1._FC_Kaiserslautern	wikicat_Association_football_clubs_established_in_1900	47	183	-136	-2.893617021276596
S.C._Freamunde	wikicat_Association_football_clubs_established_in_1933	98	383	-285	-2.9081632653061225
Enschede	wordnet_administrative_district_108491826	590	2322	-1732	-2.935593220338983
Danny_Califf	wikicat_2003_FIFA_Confederations_Cup_players	230	916	-686	-2.982608695652174
Bruno_Cirillo	wikicat_Expatriate_footballers_in_Cyprus	1	4	-3	-3.0
Nathan_Abbey	wikicat_Northampton_Town_F.C._players	1	4	-3	-3.0
Minsk	wikicat_Capitals_in_Europe	1	4	-3	-3.0
John_Kerry	wikicat_American_people_of_Scottish_descent	1	4	-3	-3.0
Simon_Donaldson	wikicat_Living_people	1	4	-3	-3.0
Herby_Fortunat	wikicat_Association_football_forwards	6	24	-18	-3.0
Paul_Robinson_(footballer,_born_1984)	wikicat_Football_Conference_players	1	4	-3	-3.0
Istanbul	wikicat_Cities_in_Turkey	1	4	-3	-3.0
Gosford	wikicat_Cities_in_Australia	1	4	-3	-3.0
Paraíba	wordnet_administrative_district_108491826	1	4	-3	-3.0
Pedro_Benítez	wikicat_Olympic_footballers_of_Paraguay	9	36	-27	-3.0
Laos	wikicat_Landlocked_countries	5	20	-15	-3.0
Nelson_Benítez	wikicat_Primeira_Liga_players	1	4	-3	-3.0
Steven_Spielberg	wikicat_American_film_producers	1	4	-3	-3.0
The_Banquet_(1991_film)	wikicat_Hong_Kong_films	1	4	-3	-3.0
Burton_Albion_F.C.	wordnet_club_108227214	1	4	-3	-3.0
Martin_Luther_King,_Jr.	wikicat_American_Christian_ministers	1	4	-3	-3.0
Alan_Dodd_(English_footballer)	wikicat_Expatriate_footballers_in_Sweden	1	4	-3	-3.0
Migen_Memelli	wikicat_Albanian_footballers	2	8	-6	-3.0
Dorinel_Munteanu	wikicat_Expatriate_footballers_in_Germany	2	8	-6	-3.0
Stockholm	wikicat_Coastal_cities_and_towns_in_Sweden	1	4	-3	-3.0
William_Faulkner	wikicat_Writers_from_Mississippi	9	36	-27	-3.0
Guimarães	wikicat_World_Heritage_Sites_in_Portugal	2	8	-6	-3.0
Liam_Neeson	wikicat_Living_people	1	4	-3	-3.0
George_Best	wikicat_Expatriate_footballers_in_Hong_Kong	3	12	-9	-3.0
Nigeria	wikicat_Member_states_of_OPEC	1	4	-3	-3.0
Michele_Fini	wikicat_Vicenza_Calcio_players	2	8	-6	-3.0
Niels_Bohr	wikicat_Danish_people	2	8	-6	-3.0
Jean-Paul_Sartre	wordnet_writer_110794014	1	4	-3	-3.0
Fontenay-sous-Bois	wikicat_Cities_in_France	1	4	-3	-3.0
Moldova	wikicat_Countries_in_Europe	1	4	-3	-3.0
James_Robertson_Justice	wikicat_British_people	1	4	-3	-3.0
Gabriel_Enrique_Gómez	wikicat_2011_CONCACAF_Gold_Cup_players	1	4	-3	-3.0
Avaí_Futebol_Clube	wordnet_club_108227214	2	8	-6	-3.0
Millwall_F.C.	wikicat_Football_clubs_in_England	1	4	-3	-3.0
George_Carlin	wikicat_Comedians_from_New_York	3	12	-9	-3.0
Rani_Mukerji	wikicat_Bengali_people	2	8	-6	-3.0
Joe_(singer)	wikicat_African-American_songwriters	2	8	-6	-3.0
Lee_Hyung-sang	wikicat_K_League_players	2	8	-6	-3.0
Lee_Mills	wikicat_Wolverhampton_Wanderers_F.C._players	3	12	-9	-3.0
Bob_Hope	wikicat_American_people_of_British_descent	2	8	-6	-3.0
Free_City_of_Lübeck	wikicat_States_of_the_Weimar_Republic	14	56	-42	-3.0
Julian_Schwinger	wikicat_American_Nobel_laureates	1	4	-3	-3.0
Martin_Luther_King,_Jr.	wikicat_Spingarn_Medal_winners	1	4	-3	-3.0
Four_Rooms	wordnet_album_106591815	4	16	-12	-3.0
Qingdao_Jonoon_F.C.	wikicat_Football_clubs_in_China	101	405	-304	-3.00990099009901
University_of_New_Brunswick	wikicat_Educational_institutions_established_in_the_1780s	66	265	-199	-3.015151515151515
Eric_Idle	wikicat_English_dramatists_and_playwrights	93	374	-281	-3.021505376344086
John_Henry_Newman	wikicat_Anglican_theologians	125	504	-379	-3.032
Andy_King_(footballer,_born_1956)	wikicat_Swindon_Town_F.C._managers	155	626	-471	-3.0387096774193547
S.V._Zulte_Waregem	wikicat_Association_football_clubs_established_in_2001	226	919	-693	-3.066371681415929
Çaykur_Rizespor	wikicat_Football_clubs_in_Turkey	34	139	-105	-3.088235294117647
Laurent_Boutonnat	wikicat_French_film_directors	11	45	-34	-3.090909090909091
Tamia	wikicat_Canadian_people	22	90	-68	-3.090909090909091
Graham_Arnold	wikicat_2007_AFC_Asian_Cup_managers	1276	5243	-3967	-3.1089341692789967
Stuart_Nicholson	wikicat_Association_football_forwards	9	37	-28	-3.111111111111111
Fort_Walton_Beach,_Florida	wordnet_administrative_district_108491826	8	33	-25	-3.125
Edmond_N'Tiamoah	wikicat_Ghanaian_expatriates_in_Switzerland	101	418	-317	-3.1386138613861387
Leeds	wikicat_Metropolitan_boroughs	7	29	-22	-3.142857142857143
Geert_den_Ouden	wikicat_Expatriate_footballers_in_Malta	1323	5488	-4165	-3.1481481481481484
Friedrich_Engels	wikicat_German_economists	19	79	-60	-3.1578947368421053
Paul_Bastock	wikicat_English_expatriate_footballers	63	262	-199	-3.1587301587301586
Friedrich_Hayek	wikicat_British_economists	6	25	-19	-3.1666666666666665
Neville_Chamberlain_(footballer)	wikicat_English_football_managers	48	200	-152	-3.1666666666666665
Eduardo_Costa	wikicat_People_from_Rio_Grande_do_Sul	6	25	-19	-3.1666666666666665
David_Cox_(statistician)	wikicat_Probability_theorists	57	239	-182	-3.192982456140351
J._R._Bremer	wikicat_Undrafted_National_Basketball_Association_players	5	21	-16	-3.2
Doris_Lessing	wikicat_20th-century_dramatists_and_playwrights	63	265	-202	-3.2063492063492065
Christopher_Hitchens	wikicat_Free_speech_activists	81	344	-263	-3.246913580246914
Massimo_Marazzina	wikicat_Italy_international_footballers	8	34	-26	-3.25
Jamie_Moralee	wikicat_Newport_County_A.F.C._players	4	17	-13	-3.25
Macclesfield_Town_F.C.	wikicat_Former_Football_League_clubs	4	17	-13	-3.25
Arne_Friedrich	wikicat_UEFA_Euro_2008_players	64	273	-209	-3.265625
China	wikicat_States_and_territories_established_in_1949	15	64	-49	-3.2666666666666666
Jarosław_Bako	wikicat_Lech_Poznań_players	25	107	-82	-3.28
Eduardo_Gonçalves_de_Oliveira	wikicat_Brazilian_expatriates_in_Germany	286	1226	-940	-3.2867132867132867
Stendhal	wikicat_Pseudonymous_writers	13	56	-43	-3.3076923076923075
Dennis_Rodman	wikicat_American_television_hosts	13	56	-43	-3.3076923076923075
Gheorghe_Hagi	wikicat_FC_Barcelona_footballers	6	26	-20	-3.3333333333333335
Changsha_Huanghua_International_Airport	wordnet_airport_102692232	3	13	-10	-3.3333333333333335
Cambridge_United_F.C.	wikicat_Football_League_clubs	3	13	-10	-3.3333333333333335
Oleksiy_Horodov	wikicat_FC_CSKA_Kyiv_players	3	13	-10	-3.3333333333333335
Stephan_Kling	wikicat_FC_Bayern_Munich_II_players	5	22	-17	-3.4
Alan_Dodd_(English_footballer)	wikicat_Rocester_F.C._players	5	22	-17	-3.4
Michael_Carrick	wikicat_England_B_international_footballers	19	84	-65	-3.4210526315789473
NK_Celje	wikicat_Unrelegated_association_football_clubs	103	456	-353	-3.4271844660194173
Bradley_Thomas_(footballer)	wikicat_King's_Lynn_F.C._players	7	31	-24	-3.4285714285714284
Søren_Kierkegaard	wikicat_Danish_people	51	226	-175	-3.4313725490196076
Zakari_Lambo	wikicat_VfR_Mannheim_players	434	1925	-1491	-3.435483870967742
Bechara_Oliveira	wikicat_Odense_Boldklub_players	34	151	-117	-3.4411764705882355
E.S._Troyes_A.C.	wikicat_Association_football_clubs_established_in_1900	114	508	-394	-3.456140350877193
A.S._Bari	wikicat_Association_football_clubs_established_in_1908	13	58	-45	-3.4615384615384617
Julianne_Moore	wikicat_Actors_from_New_York_City	62	278	-216	-3.4838709677419355
Matthew_Broderick	wikicat_American_people_of_British_descent	12	54	-42	-3.5
Scott_Willis_(footballer)	wikicat_Halifax_Town_A.F.C._players	26	117	-91	-3.5
Peterborough	wikicat_Cities_in_the_East_of_England	8	36	-28	-3.5
Frank_Sinatra	wikicat_American_voice_actors	2	9	-7	-3.5
Kingstonian_F.C.	wikicat_Football_clubs_in_England	2	9	-7	-3.5
David_Sedaris	wikicat_American_comedians	4	18	-14	-3.5
Cordillera_Administrative_Region	wikicat_Regions_of_the_Philippines	2	9	-7	-3.5
Orly_Airport	wordnet_airport_102692232	2	9	-7	-3.5
Maurizio_Gaudino	wikicat_VfL_Bochum_players	2	9	-7	-3.5
Steven_Tyler	wikicat_Idols_(TV_series)_judges	168	771	-603	-3.5892857142857144
Colorado_Rapids	wikicat_Association_football_clubs_established_in_1996	8	37	-29	-3.625
Vlatko_Marković	wikicat_Yugoslav_football_managers	27	125	-98	-3.6296296296296298
Caracas_FC	wikicat_Association_football_clubs_established_in_1984	137	639	-502	-3.664233576642336
Georges_Bataille	wikicat_Continental_philosophers	3	14	-11	-3.6666666666666665
Lionel_Messi	wikicat_Argentina_youth_international_footballers	6	28	-22	-3.6666666666666665
Warren,_Michigan	wordnet_administrative_district_108491826	3	14	-11	-3.6666666666666665
Djamel_Abdoun	wikicat_The_Football_League_players	3	14	-11	-3.6666666666666665
Frances_Goodrich	wikicat_American_dramatists_and_playwrights	3	14	-11	-3.6666666666666665
Ferrara	wikicat_World_Heritage_Sites_in_Europe	3	14	-11	-3.6666666666666665
Susan_Sontag	wikicat_Bisexual_women	882	4123	-3241	-3.6746031746031744
San_Luis_F.C.	wikicat_Defunct_football_clubs_in_Mexico	4	19	-15	-3.75
Fabio_Nigro	wikicat_Serie_B_footballers	4	19	-15	-3.75
Massachusetts_Institute_of_Technology	wikicat_Universities_and_colleges_in_Cambridge,_Massachusetts	12	57	-45	-3.75
Pichincha_Province	wikicat_States_and_territories_established_in_1824	27	129	-102	-3.7777777777777777
Ricky_Gervais	wikicat_Atheism_activists	60	288	-228	-3.8
Aaran_Lines	wikicat_2003_FIFA_Confederations_Cup_players	472	2268	-1796	-3.805084745762712
Christian_Callejas	wikicat_Expatriate_footballers_in_Paraguay	11	53	-42	-3.8181818181818183
C._S._Lewis	wikicat_British_philosophers	6	29	-23	-3.8333333333333335
Oxford	wikicat_Cities_in_South_East_England	7	34	-27	-3.857142857142857
Stéphane_Zubar	wikicat_Association_football_defenders	8	39	-31	-3.875
Allan_Nielsen	wikicat_Danish_football_managers	8	39	-31	-3.875
Kurt_Vonnegut	wikicat_American_people_of_German_descent	10	49	-39	-3.9
George_Berkeley	wikicat_People_from_Dublin_(city)	175	858	-683	-3.902857142857143
Bruno_Šundov	wikicat_Maccabi_Tel_Aviv_B.C._players	53	262	-209	-3.943396226415094
US_Boulogne	wikicat_Association_football_clubs_established_in_1898	245	1221	-976	-3.983673469387755
Carlos_Navarro_Montoya	wikicat_Expatriate_footballers_in_Argentina	1	5	-4	-4.0
Jean-Luc_Godard	wikicat_Film_producers	1	5	-4	-4.0
Freetown	wikicat_Port_cities_in_Africa	1	5	-4	-4.0
Carlos_Valderrama	wikicat_1993_Copa_América_players	26	130	-104	-4.0
Peter_Kropotkin	wikicat_Atheist_philosophers	8	40	-32	-4.0
Australia	wikicat_Federal_countries	6	30	-24	-4.0
Peloponnese	wikicat_Peninsulas_of_Europe	1	5	-4	-4.0
Lyndon_B._Johnson	wikicat_People_of_the_Vietnam_War	11	55	-44	-4.0
Mercedes_Lackey	wikicat_20th-century_women_writers	1	5	-4	-4.0
Tampa,_Florida	wordnet_administrative_district_108491826	1	5	-4	-4.0
Pakistan	wikicat_Member_states_of_the_Commonwealth_of_Nations	1	5	-4	-4.0
Rutgers_University	wikicat_Universities_and_colleges_in_New_Jersey	2	10	-8	-4.0
Rossendale_United_F.C.	wordnet_club_108227214	3	15	-12	-4.0
Guangzhou_Baiyun_International_Airport	wordnet_airport_102692232	2	10	-8	-4.0
Milan_Kundera	wikicat_Writers_who_illustrated_their_own_writing	2	10	-8	-4.0
Prekmurje	wikicat_Regions_of_Slovenia	2	10	-8	-4.0
Carl_Sagan	wikicat_Jewish_agnostics	3	15	-12	-4.0
Agnaldo_Cordeiro_Pereira	wikicat_Brazilian_expatriates_in_South_Korea	3	15	-12	-4.0
Santos_FC	wordnet_club_108227214	1	5	-4	-4.0
Dwight_D._Eisenhower	wikicat_Cold_War_leaders	2	10	-8	-4.0
Riyadh	wikicat_Provincial_capitals_of_Saudi_Arabia	1	5	-4	-4.0
Connecticut_Wolves	wikicat_USISL_teams	3	15	-12	-4.0
Arabic_language	wikicat_Languages_of_Gibraltar	2	10	-8	-4.0
José_Veiga	wikicat_The_Football_League_players	1	5	-4	-4.0
David_Lynch	wikicat_American_cartoonists	516	2583	-2067	-4.005813953488372
Beirut	wikicat_Amarna_letters_locations	211	1058	-847	-4.014218009478673
John_Bates_Clark_Medal	wikicat_Economics_awards	21	107	-86	-4.095238095238095
Francis_Bacon	wikicat_Empiricists	29	150	-121	-4.172413793103448
FC_Dynamo_Stavropol	wikicat_Football_clubs_in_Russia	374	1941	-1567	-4.189839572192513
Holger_Fach	wikicat_FC_Augsburg_managers	21	109	-88	-4.190476190476191
Jamie_Lee_Curtis	wikicat_American_people_of_Hungarian-Jewish_descent	35	182	-147	-4.2
Luton_Town_F.C.	wikicat_Football_clubs_in_England	4	21	-17	-4.25
Alameda_County,_California	wikicat_Counties_in_the_San_Francisco_Bay_Area	4	21	-17	-4.25
Kraljevo	wikicat_Municipalities_and_cities_of_Šumadija_and_Western_Serbia	12	63	-51	-4.25
Segundo_Castillo	wikicat_Serbian_SuperLiga_players	16	84	-68	-4.25
Tunis	wikicat_Populated_places_established_in_the_2nd_millennium_BC	921	4839	-3918	-4.254071661237785
Hamburg	wikicat_Port_cities_and_towns_of_the_North_Sea	46	245	-199	-4.326086956521739
Lon_Chaney_(Sr.)	wikicat_Silent_film_directors	18	96	-78	-4.333333333333333
Stevenage_F.C.	wikicat_Football_clubs_in_England	6	32	-26	-4.333333333333333
Liam_Burns	wikicat_Football_Conference_players	3	16	-13	-4.333333333333333
Monterrey	wordnet_administrative_district_108491826	3	16	-13	-4.333333333333333
Marcus_Vinícius_da_Cruz_Alves_Nóbrega	wikicat_People_from_Rio_de_Janeiro_(city)	11	59	-48	-4.363636363636363
Vlatko_Marković	wikicat_Croatia_national_football_team_managers	33	177	-144	-4.363636363636363
Nenad_Stojanović	wikicat_Yugoslav_footballers	30	161	-131	-4.366666666666666
Steve_Mardenborough	wikicat_Darlington_F.C._players	98	527	-429	-4.377551020408164
Boca_Unidos	wikicat_Basketball_teams_in_Argentina	5	27	-22	-4.4
Michel_Aflaq	wikicat_Arab_nationalists	777	4203	-3426	-4.409266409266409
Tom_Brighton	wikicat_Rangers_F.C._players	7	38	-31	-4.428571428571429
Gene_Kelly	wikicat_American_male_musical_theatre_actors	42	228	-186	-4.428571428571429
Order_of_the_Star_of_Italian_Solidarity	wikicat_Awards_established_in_1947	137	747	-610	-4.452554744525547
Óscar_Díaz_González	wikicat_Celta_de_Vigo_footballers	2	11	-9	-4.5
Atari	wikicat_Video_game_development_companies	2	11	-9	-4.5
Sebastian_Helbig	wikicat_Germany_youth_international_footballers	6	33	-27	-4.5
Thiruvananthapuram	wordnet_administrative_district_108491826	36	200	-164	-4.555555555555555
Boaz_Myhill	wikicat_Association_football_goalkeepers	9	50	-41	-4.555555555555555
Quebec	wikicat_Romance_countries_and_territories	10	56	-46	-4.6
Tameside	wikicat_Cities_in_North_West_England	5	28	-23	-4.6
Wrexham_F.C.	wikicat_Former_Football_League_clubs	22	124	-102	-4.636363636363637
Novo_Mesto	wordnet_administrative_district_108491826	120	678	-558	-4.65
Josiesley_Ferreira_Rosa	wikicat_Clube_Atlético_Mineiro_players	40	226	-186	-4.65
Lille_OSC	wordnet_club_108227214	3	17	-14	-4.666666666666667
Aristotle	wikicat_Philosophers_of_language	35	200	-165	-4.714285714285714
Shimizu_S-Pulse	wikicat_Association_football_clubs_established_in_1991	84	482	-398	-4.738095238095238
George_Gebro	wikicat_Hapoel_Petah_Tikva_F.C._players	57	328	-271	-4.754385964912281
Alexander_Haig	wikicat_American_generals	29	168	-139	-4.793103448275862
Johann_Gottlieb_Fichte	wikicat_Christian_philosophers	5	29	-24	-4.8
Amha_Selassie	wikicat_Knights_of_the_Royal_Order_of_the_Seraphim	18	105	-87	-4.833333333333333
Julio_César_Cáceres	wikicat_Association_football_central_defenders	6	35	-29	-4.833333333333333
Carlos_Navarro_Montoya	wikicat_Deportes_Concepción_footballers	87	517	-430	-4.942528735632184
José_Ferrer	wikicat_Princeton_University_alumni	402	2409	-2007	-4.992537313432836
Mahakali_Zone	wikicat_Subdivisions_of_Nepal	1	6	-5	-5.0
Starachowice_County	wordnet_administrative_district_108491826	1	6	-5	-5.0
Aleksandar_Jevtić	wikicat_Association_football_forwards	3	18	-15	-5.0
Geno_Carlisle	wikicat_Karşıyaka_basketball_players	1	6	-5	-5.0
Christian_Democracy_(Italy)	wikicat_Defunct_political_parties	1	6	-5	-5.0
Jeffrey_Jones	wikicat_American_stage_actors	1	6	-5	-5.0
Modestas_Stonys	wikicat_Living_people	1	6	-5	-5.0
Alphonse_Tchami	wikicat_Expatriate_footballers_in_China	1	6	-5	-5.0
Drama_Desk_Award	wordnet_award_106696483	1	6	-5	-5.0
Socialist_Federal_Republic_of_Yugoslavia	wikicat_Former_countries_in_Europe	1	6	-5	-5.0
Santiago_Salcedo	wikicat_Paraguay_international_footballers	5	30	-25	-5.0
Siyabonga_Nomvethe	wikicat_2010_FIFA_World_Cup_players	3	18	-15	-5.0
Northampton_Town_F.C.	wikicat_Football_League_clubs	2	12	-10	-5.0
Honoré_de_Balzac	wikicat_French_monarchists	138	828	-690	-5.0
Sandra_Bullock	wikicat_American_film_producers	4	24	-20	-5.0
Moldova	wikicat_Romance_countries_and_territories	21	127	-106	-5.0476190476190474
Socialist_Party_(France)	wikicat_Socialist_parties	8	49	-41	-5.125
Rijeka	wikicat_Capitals_of_former_nations	29	179	-150	-5.172413793103448
Mike_Pollitt	wikicat_Burnley_F.C._players	17	106	-89	-5.235294117647059
Dwight_D._Eisenhower	wikicat_United_States_Army_generals	40	251	-211	-5.275
Kolkata	wikicat_Cities_with_millions_of_inhabitants	7	44	-37	-5.285714285714286
I._M._Pei	wikicat_People_from_Guangzhou	151	951	-800	-5.298013245033113
Giovane_Élber	wikicat_Olympique_Lyonnais_players	28	177	-149	-5.321428571428571
Lionel_Messi	wikicat_2011_Copa_América_players	9	57	-48	-5.333333333333333
Marijan_Kovačević	wikicat_NK_Široki_Brijeg_players	81	515	-434	-5.3580246913580245
Delron_Buckley	wikicat_Maritzburg_United_F.C._players	128	814	-686	-5.359375
Dublin	wikicat_Towns_and_villages_in_County_Dublin	2070	13168	-11098	-5.361352657004831
Amartya_Sen	wikicat_Living_people	5	32	-27	-5.4
Stevenage_F.C.	wikicat_Football_clubs_in_Hertfordshire	51	328	-277	-5.431372549019608
Borough_of_Fylde	wordnet_administrative_district_108491826	2	13	-11	-5.5
Bedfordshire	wordnet_county_108546183	2	13	-11	-5.5
Zielona_Góra_County	wikicat_Counties_of_Poland	494	3237	-2743	-5.552631578947368
George_Carlin	wikicat_American_political_writers	9	60	-51	-5.666666666666667
Ronald_Fisher	wikicat_Geneticists	96	640	-544	-5.666666666666667
Steven_Caldwell	wikicat_Association_football_defenders	6	40	-34	-5.666666666666667
Patsy_Cline	wikicat_Country_singers	3	20	-17	-5.666666666666667
Bavaria	wordnet_administrative_district_108491826	3	20	-17	-5.666666666666667
Hilary_Duff	wikicat_American_women_novelists	80	535	-455	-5.6875
Carl_Sagan	wikicat_American_pacifists	10	67	-57	-5.7
Alexander_Graham_Bell	wikicat_American_engineers	41	278	-237	-5.780487804878049
George_Santayana	wikicat_American_novelists	5	34	-29	-5.8
Walt_Disney	wikicat_American_cartoonists	327	2240	-1913	-5.850152905198777
Nacer_Abdellah	wikicat_FC_Den_Bosch_players	151	1053	-902	-5.973509933774834
Shrewsbury_Town_F.C.	wordnet_club_108227214	1	7	-6	-6.0
Toronto	wikicat_Populated_places_on_the_Great_Lakes	1	7	-6	-6.0
Bujumbura	wikicat_Cities_in_the_Great_Rift_Valley	2	14	-12	-6.0
Brooke_Shields	wikicat_American_child_actresses	1	7	-6	-6.0
Federal_District_(Brazil)	wordnet_administrative_district_108491826	1	7	-6	-6.0
Mississippi_River	wordnet_river_109411430	1	7	-6	-6.0
Sayaji_Shinde	wikicat_Actors_in_Hindi_cinema	3	21	-18	-6.0
Cambridge	wikicat_Districts_of_England	4	28	-24	-6.0
Belarus_national_football_team	wikicat_European_national_association_football_teams	1	7	-6	-6.0
Silver_Star	wikicat_Courage_awards	3	21	-18	-6.0
Taiyuan	wikicat_Populated_places_established_in_the_1st_millennium_BC	1805	12657	-10852	-6.012188365650969
Milan	wikicat_Populated_places_established_in_the_1st_millennium_BC	74	519	-445	-6.013513513513513
Manzhouli_Xijiao_Airport	wordnet_airport_102692232	302	2119	-1817	-6.016556291390729
Raoul_Bott	wikicat_Carnegie_Mellon_University_alumni	82	577	-495	-6.036585365853658
Palm_Springs,_California	wikicat_Populated_places_established_in_1896	186	1313	-1127	-6.059139784946237
Art_Prize_of_the_German_Democratic_Republic	wikicat_Art_awards	12	85	-73	-6.083333333333333
Dundee	wikicat_Cities_in_the_United_Kingdom	382	2712	-2330	-6.099476439790576
Glasgow	wikicat_Populated_places_established_in_the_6th_century	47	337	-290	-6.170212765957447
FK_Hajduk_Kula	wikicat_Association_football_clubs_established_in_1912	24	173	-149	-6.208333333333333
Frank_Sinatra	wikicat_American_male_voice_actors	9	65	-56	-6.222222222222222
Pepe_Reina	wikicat_Madrilenian_footballers	3	22	-19	-6.333333333333333
Leipzig_University	wikicat_Educational_institutions_established_in_the_15th_century	43	317	-274	-6.372093023255814
TuS_Celle_FC	wikicat_Association_football_clubs_established_in_1945	24	177	-153	-6.375
Kemi	wikicat_Populated_places_established_in_1869	1307	9660	-8353	-6.39097169089518
S.E.F._Torres_1903	wikicat_Association_football_clubs_established_in_1903	11	82	-71	-6.454545454545454
Sun_Hei_SC	wikicat_Association_football_clubs_established_in_1986	43	321	-278	-6.465116279069767
Uladzimir_Karytska	wikicat_Expatriate_footballers_in_Slovakia	2	15	-13	-6.5
Second_Boer_War	wikicat_Wars_involving_the_states_and_peoples_of_Africa	4	30	-26	-6.5
Pyrzyce_County	wikicat_Counties_of_Poland	23	173	-150	-6.521739130434782
Hong_Kong	wikicat_Metropolitan_areas	390	2976	-2586	-6.630769230769231
Brigit_of_Kildare	wikicat_Roman_Catholic_saints	8	62	-54	-6.75
Vermont	wikicat_Populated_places_established_in_1791	311	2423	-2112	-6.790996784565916
Poul_Anderson	wikicat_21st-century_writers	14	110	-96	-6.857142857142857
Zagłębie_Lubin	wikicat_Football_clubs_in_Poland	110	865	-755	-6.863636363636363
James_Stansfield	wikicat_Guiseley_A.F.C._players	10	79	-69	-6.9
Richard_Dawkins	wikicat_Critics_of_religions	17	135	-118	-6.9411764705882355
Wolfgang_Frank	wikicat_VfB_Stuttgart_players	52	413	-361	-6.9423076923076925
Igor_Stojaković	wikicat_People_from_Kraljevo	36	287	-251	-6.972222222222222
Dorge_Kouemaha	wikicat_Expatriate_footballers_in_Hungary	10	80	-70	-7.0
Mao_Zedong	wikicat_Revolutionaries	2	16	-14	-7.0
Reto_Ziegler	wikicat_Expatriate_footballers_in_Russia	2	16	-14	-7.0
Racing_Club_de_Montevideo	wordnet_club_108227214	1	8	-7	-7.0
Wladimir_Baýramow	wikicat_Expatriate_footballers_in_Kazakhstan	1	8	-7	-7.0
Langarud_County	wikicat_Counties_of_Iran	1	8	-7	-7.0
Enköping_Municipality	wordnet_administrative_district_108491826	1	8	-7	-7.0
Zarand_County	wordnet_administrative_district_108491826	1	8	-7	-7.0
University_of_Lisbon	wordnet_university_108286569	1	8	-7	-7.0
M._S._Swaminathan	wikicat_Fellows_of_the_Royal_Society	1	8	-7	-7.0
Hermann_Hreiðarsson	wikicat_Brentford_F.C._players	30	243	-213	-7.1
MYPA	wordnet_club_108227214	8	65	-57	-7.125
Julia_Kristeva	wikicat_Fellows_of_the_British_Academy	5	41	-36	-7.2
Carl_Dickinson	wikicat_English_expatriates_in_Iceland	119	987	-868	-7.294117647058823
Kurt_Hamrin	wikicat_A.C._Milan_players	12	100	-88	-7.333333333333333
George_R._R._Martin	wikicat_American_television_producers	3	25	-22	-7.333333333333333
John_F._Kennedy	wikicat_20th-century_American_writers	3	25	-22	-7.333333333333333
Army_United_F.C.	wikicat_Association_football_clubs_established_in_1964	263	2206	-1943	-7.387832699619772
Robert_Solow	wikicat_Living_people	11	93	-82	-7.454545454545454
James_Stansfield	wikicat_Liversedge_F.C._players	23	198	-175	-7.608695652173913
Edinburgh	wordnet_administrative_district_108491826	13	113	-100	-7.6923076923076925
Prescot_Cables_F.C.	wikicat_Football_clubs_in_England	5	44	-39	-7.8
Esfarayen_County	wordnet_administrative_district_108491826	1	9	-8	-8.0
Rodney_Jerkins	wikicat_American_record_producers	1	9	-8	-8.0
North_Holland	wikicat_States_and_territories_established_in_1840	1	9	-8	-8.0
Daniel_Pendín	wikicat_Expatriate_footballers_in_Spain	2	18	-16	-8.0
India	wikicat_Socialist_states	1	9	-8	-8.0
Boaz_Myhill	wikicat_Welsh_footballers	1	9	-8	-8.0
Frankfurt	wikicat_University_towns_in_Germany	1	9	-8	-8.0
Iain_Fyfe	wikicat_K_League_players	2	18	-16	-8.0
Acre_(state)	wordnet_administrative_district_108491826	1	9	-8	-8.0
Carl_Sagan	wikicat_American_activists	1	9	-8	-8.0
Bury_F.C.	wordnet_club_108227214	2	18	-16	-8.0
Marcos_Paulo_Alves	wikicat_Yokohama_F.C._players	1	9	-8	-8.0
Robert_Bunsen	wikicat_19th-century_German_people	21	192	-171	-8.142857142857142
Mitt_Romney	wikicat_Massachusetts_politicians	37	339	-302	-8.162162162162161
University_of_São_Paulo	wikicat_Universities_and_colleges	227	2080	-1853	-8.162995594713657
Steve_Jones_(Northern_Irish_footballer)	wikicat_Bradford_City_A.F.C._players	17	156	-139	-8.176470588235293
Philipps_University_of_Marburg	wikicat_Universities_and_colleges_in_Hesse	4	37	-33	-8.25
Nicolás_Muñoz	wikicat_Association_football_forwards	11	102	-91	-8.272727272727273
Paulus_Roiha	wikicat_Cercle_Brugge_K.S.V._players	13	121	-108	-8.307692307692308
Sarasota,_Florida	wordnet_administrative_district_108491826	3	28	-25	-8.333333333333334
Paul_Simpson_(footballer)	wikicat_Stockport_County_F.C._managers	230	2152	-1922	-8.356521739130434
Krasnodar_Krai	wordnet_administrative_district_108491826	5	47	-42	-8.4
Giulio_Andreotti	wikicat_Senators_of_the_Republic_of_Italy	2	19	-17	-8.5
Raymond_Poincaré	wikicat_Knights_of_the_Golden_Fleece	2	19	-17	-8.5
Pete_Seeger	wikicat_American_tax_resisters	92	875	-783	-8.51086956521739
Nicolaus_Copernicus_University_in_Toruń	wordnet_university_108286569	7	67	-60	-8.571428571428571
George_Abbott	wikicat_Writers_from_New_York_City	54	518	-464	-8.592592592592593
David_Bohm	wikicat_Jewish_agnostics	3	29	-26	-8.666666666666666
Malmö_FF	wikicat_Association_football_clubs_established_in_1910	13	126	-113	-8.692307692307692
Quarentinha	wikicat_América_de_Cali_footballers	4	39	-35	-8.75
Polonia_Warsaw	wikicat_Multi-sport_clubs	1	10	-9	-9.0
Krunoslav_Lovrek	wikicat_Croatian_expatriate_footballers	1	10	-9	-9.0
Carlton_Fairweather	wikicat_Expatriate_footballers_in_Hong_Kong	1	10	-9	-9.0
Carlton_Fairweather	wikicat_Connecticut_Wolves_players	1	10	-9	-9.0
Matt_Carmichael_(footballer)	wikicat_Barnet_F.C._players	2	20	-18	-9.0
Quentin_Tarantino	wikicat_American_people_of_Italian_descent	1	10	-9	-9.0
San_Martín_de_San_Juan	wikicat_Football_clubs_in_Argentina	179	1797	-1618	-9.039106145251397
Herby_Fortunat	wikicat_Besa_Kavajë_players	39	394	-355	-9.102564102564102
Shqipran_Skeraj	wikicat_Djurgårdens_IF_Fotboll_players	148	1496	-1348	-9.108108108108109
Kashmir_Valley	wikicat_Princely_states_of_India	8	81	-73	-9.125
Galatasaray_S.K.	wikicat_Association_football_clubs_established_in_1905	192	1958	-1766	-9.197916666666666
Chris_Coyne	wikicat_Colchester_United_F.C._players	34	347	-313	-9.205882352941176
Jagiellonia_Białystok	wikicat_Football_clubs_in_Poland	167	1715	-1548	-9.269461077844312
Jonathan_Gould	wikicat_Clevedon_Town_F.C._players	6	62	-56	-9.333333333333334
Daniel_McBreen	wikicat_Expatriate_footballers_in_China	23	238	-215	-9.347826086956522
Landskrona_BoIS	wordnet_club_108227214	59	614	-555	-9.40677966101695
Michel_Rocard	wikicat_Lycée_Louis-le-Grand_alumni	2	21	-19	-9.5
Democrata_Futebol_Clube	wikicat_Association_football_clubs_established_in_1914	4	42	-38	-9.5
Nenad_Mladenović	wikicat_Expatriate_footballers_in_Ukraine	4	42	-38	-9.5
Martin_Luther_King,_Jr.	wikicat_American_anti–Vietnam_War_activists	7	74	-67	-9.571428571428571
VfL_Wolfsburg	wikicat_Football_clubs_in_Lower_Saxony	6	64	-58	-9.666666666666666
Santa_Monica	wordnet_administrative_district_108491826	2	22	-20	-10.0
Max_Kruse	wikicat_SV_Werder_Bremen_players	1	11	-10	-10.0
Maidstone	wordnet_site_108651247	1	11	-10	-10.0
Steven_Tyler	wikicat_American_people_of_Ukrainian_descent	1	11	-10	-10.0
Wallace_Shawn	wikicat_Jewish_actors	1	11	-10	-10.0
Harry_B._Gray	wikicat_American_chemists	1	11	-10	-10.0
Leeds	wordnet_administrative_district_108491826	15	165	-150	-10.0
Esporte_Clube_XV_de_Novembro_(Piracicaba)	wikicat_Football_clubs_in_Brazil	2	22	-20	-10.0
John_Kerry	wikicat_Anti–death_penalty_activists	43	480	-437	-10.162790697674419
Chakhir_Belghazouani	wikicat_Morocco_international_footballers	15	169	-154	-10.266666666666667
John_Badham	wikicat_English_television_directors	16	181	-165	-10.3125
RWDM_Brussels_FC	wikicat_Football_clubs_in_Belgium	298	3381	-3083	-10.345637583892618
Michael_Thwaite	wikicat_Wisła_Kraków_players	13	148	-135	-10.384615384615385
Cuca_(footballer)	wikicat_Associação_Chapecoense_de_Futebol_players	192	2250	-2058	-10.71875
FC_Chiasso	wikicat_Italian_football_First_Division_clubs	197	2326	-2129	-10.807106598984772
Abū_Rayḥān_al-Bīrūnī	wikicat_Meteorologists	23	275	-252	-10.956521739130435
Lower_Normandy	wordnet_administrative_district_108491826	1	12	-11	-11.0
Dele_Adeleye	wikicat_Olympic_medalists_in_football	1	12	-11	-11.0
Stockholm	wordnet_administrative_district_108491826	1	12	-11	-11.0
Roy_Hodgson	wikicat_Serie_A_managers	2	24	-22	-11.0
Jeremiah_Denton	wikicat_Prisoners_of_war	1	12	-11	-11.0
Cambridge	wikicat_Non-metropolitan_districts	2	24	-22	-11.0
Concord_Rangers_F.C.	wikicat_Football_clubs_in_England	1	12	-11	-11.0
David_Craig_(Scottish_footballer)	wikicat_Expatriate_footballers_in_Hong_Kong	3	36	-33	-11.0
Upton_Sinclair	wikicat_People_from_Englewood,_New_Jersey	1	12	-11	-11.0
Kadrina_Parish	wordnet_administrative_district_108491826	1	12	-11	-11.0
Werder_Bremen	wikicat_Multi-sport_clubs_in_Germany	1	12	-11	-11.0
Saskatoon	wikicat_Populated_places_established_in_1883	222	2668	-2446	-11.018018018018019
Duchy_of_Styria	wikicat_Divided_regions	74	896	-822	-11.108108108108109
Maccabi_Netanya_F.C.	wikicat_Association_football_clubs_established_in_1934	5	61	-56	-11.2
Mamadou_Bagayoko	wikicat_The_Football_League_players	8	98	-90	-11.25
Tom_Brighton	wikicat_Association_football_strikers	168	2069	-1901	-11.31547619047619
Hapoel_Galil_Elyon	wordnet_club_108227214	6	74	-68	-11.333333333333334
Eric_Clapton	wikicat_Blues_singers	8	100	-92	-11.5
Leon_Best	wikicat_Association_football_forwards	2	25	-23	-11.5
Quarentinha	wikicat_Association_football_forwards	4	51	-47	-11.75
Gilbert_Bodart	wikicat_Belgium_international_footballers	6	77	-71	-11.833333333333334
Benoit_Mandelbrot	wikicat_American_economists	166	2156	-1990	-11.987951807228916
FC_Torpedo-ZIL_Moscow	wikicat_Defunct_football_clubs_in_Russia	3	39	-36	-12.0
Eugene_Wigner	wikicat_Jewish_physicists	2	26	-24	-12.0
Roger_Milla	wikicat_Valenciennes_FC_players	1	13	-12	-12.0
Chennai	wordnet_administrative_district_108491826	1	13	-12	-12.0
Prague_Václav_Havel_Airport	wikicat_Airfields_of_the_United_States_Army_Air_Forces_Air_Transport_Command_in_the_European_Theater	2	27	-25	-12.5
Dorchester_Town_F.C.	wikicat_Association_football_clubs_established_in_1880	51	706	-655	-12.843137254901961
Bono	wikicat_Irish_rock_singers	16	223	-207	-12.9375
Chakhir_Belghazouani	wikicat_Moroccan_footballers	16	225	-209	-13.0625
Slunj	wordnet_administrative_district_108491826	14	198	-184	-13.142857142857142
Świebodzin_County	wikicat_Counties_of_Poland	166	2354	-2188	-13.180722891566266
Ezequiel_Lavezzi	wikicat_Medalists_at_the_2008_Summer_Olympics	9	128	-119	-13.222222222222221
SK_Brann	wikicat_Defunct_athletics_clubs_in_Norway	3	44	-41	-13.666666666666666
Andy_Webster	wikicat_Association_football_defenders	3	44	-41	-13.666666666666666
Andy_King_(footballer,_born_1956)	wikicat_Waterford_United_F.C._managers	147	2174	-2027	-13.789115646258503
Deportivo_Pereira	wikicat_Association_football_clubs_established_in_1944	34	503	-469	-13.794117647058824
Clint_Eastwood	wikicat_American_male_actors	1	15	-14	-14.0
Juan_José_Borrelli	wikicat_Argentina_international_footballers	1	15	-14	-14.0
Alice_Springs_Airport	wordnet_airport_102692232	6	91	-85	-14.166666666666666
R.A.A._Louviéroise	wikicat_Association_football_clubs_disestablished_in_2009	37	568	-531	-14.35135135135135
Alex_Williams_(footballer_born_1983)	wikicat_Dundalk_F.C._players	43	665	-622	-14.465116279069768
Ruch_Chorzów	wikicat_Football_clubs_in_Poland	6	93	-87	-14.5
Świebodzin_County	wordnet_administrative_district_108491826	1	16	-15	-15.0
ABC_Futebol_Clube	wikicat_Football_clubs_in_Brazil	342	5477	-5135	-15.014619883040936
Artavazd_Karamyan	wikicat_Armenia_international_footballers	5	82	-77	-15.4
FK_Hajduk_Kula	wikicat_Association_football_clubs_disestablished_in_2013	84	1385	-1301	-15.488095238095237
Bahawalpur_District	wordnet_administrative_district_108491826	2	33	-31	-15.5
Sciences_Po	wikicat_Schools_of_international_relations	25	420	-395	-15.8
Liverpool_F.C.	wikicat_Association_football_clubs_established_in_1892	128	2168	-2040	-15.9375
Anderson_County,_Tennessee	wikicat_Counties_of_Appalachia	1	17	-16	-16.0
Tottenham_Hotspur_F.C.	wikicat_Publicly_traded_sports_companies	1	17	-16	-16.0
Hetman_Zamość	wordnet_club_108227214	1	17	-16	-16.0
Özden_Öngün	wikicat_Sakaryaspor_footballers	115	2004	-1889	-16.42608695652174
Oliver_Ryan	wikicat_Ilkeston_Town_F.C._players	2	35	-33	-16.5
AS_Khroub	wikicat_Association_football_clubs_established_in_1927	36	633	-597	-16.583333333333332
California_State_University,_Long_Beach	wordnet_university_108286569	1	18	-17	-17.0
Josiesley_Ferreira_Rosa	wikicat_Association_football_forwards	2	36	-34	-17.0
Bjelovar	wikicat_Cities_and_towns_in_Croatia	1	19	-18	-18.0
Søren_Kierkegaard	wikicat_Christian_philosophers	4	76	-72	-18.0
Daniel_Dennett	wikicat_Analytic_philosophers	4	76	-72	-18.0
Pennington_County,_South_Dakota	wordnet_county_108546183	3	58	-55	-18.333333333333332
Rot_Weiss_Ahlen	wikicat_Association_football_clubs_established_in_1996	300	5827	-5527	-18.423333333333332
Caleb_Patterson-Sewell	wikicat_Liverpool_F.C._players	1	20	-19	-19.0
RKS_Radomsko	wordnet_club_108227214	1	20	-19	-19.0
West_Azerbaijan_Province	wordnet_site_108651247	148	3020	-2872	-19.405405405405407
Auckland_City_FC	wordnet_club_108227214	8	167	-159	-19.875
Centre_region,_France	wordnet_administrative_district_108491826	1	21	-20	-20.0
Spennymoor_Town_F.C.	wordnet_club_108227214	2	42	-40	-20.0
Zala_County	wordnet_administrative_district_108491826	3	63	-60	-20.0
Nice	wikicat_Ancient_Greek_cities	183	3859	-3676	-20.08743169398907
Bavarian_Order_of_Merit	wordnet_award_106696483	3	65	-62	-20.666666666666668
Pascal_Zuberbühler	wikicat_Swiss-German_people	30	679	-649	-21.633333333333333
Souss-Massa-Drâa	wordnet_administrative_district_108491826	3	68	-65	-21.666666666666668
Stockport_County_F.C.	wordnet_club_108227214	1	23	-22	-22.0
University_of_Warsaw	wordnet_university_108286569	8	191	-183	-22.875
Gary_Moore	wikicat_Irish_musicians	1	24	-23	-23.0
Dewsbury	wikicat_Cities_in_England	1	24	-23	-23.0
Dolph_Lundgren	wikicat_People_from_Stockholm	18	437	-419	-23.27777777777778
Manuel_Blum	wikicat_Living_people	8	197	-189	-23.625
Order_of_the_White_Lion	wikicat_Military_awards_and_decorations	2	50	-48	-24.0
Sardinia	wordnet_administrative_district_108491826	4	100	-96	-24.0
Boz_Scaggs	wikicat_Blues_rock_musicians	1	26	-25	-25.0
Australian_Capital_Territory	wikicat_Enclaves	54	1417	-1363	-25.24074074074074
Valparaíso	wordnet_administrative_district_108491826	5	134	-129	-25.8
1._FC_Cologne	wikicat_Association_football_clubs_established_in_1948	8	224	-216	-27.0
Thuringia	wikicat_States_of_the_Weimar_Republic	2	57	-55	-27.5
Brian_O'Nolan	wikicat_Pseudonymous_writers	2	57	-55	-27.5
John_McGlashan_(footballer)	wikicat_Cambridge_United_F.C._players	6	172	-166	-27.666666666666668
Blace	wikicat_Municipalities_and_cities_of_Southern_and_Eastern_Serbia	1	29	-28	-28.0
Čakovec	wordnet_administrative_district_108491826	21	617	-596	-28.38095238095238
Tigray_Region	wordnet_administrative_district_108491826	10	299	-289	-28.9
Swansea	wordnet_administrative_district_108491826	6	183	-177	-29.5
Negeri_Sembilan_FA	wikicat_Association_football_clubs	15	462	-447	-29.8
Birmingham	wordnet_administrative_district_108491826	1	31	-30	-30.0
Nouméa	wordnet_commune_108541609	45	1404	-1359	-30.2
Jesús_Franco	wikicat_People_from_Madrid	3	96	-93	-31.0
FC_Zorya_Luhansk	wikicat_Association_football_clubs_established_in_1923	3	97	-94	-31.333333333333332
Larne	wikicat_Port_cities	27	891	-864	-32.0
Nelson_Mandela	wikicat_Pacifists	5	167	-162	-32.4
TN_postcode_area	wordnet_area_108497294	2	68	-66	-33.0
Stocksbridge_Park_Steels_F.C.	wikicat_Football_clubs_in_South_Yorkshire	1	34	-33	-33.0
Grand_Rapids,_Michigan	wikicat_University_towns_in_the_United_States	35	1212	-1177	-33.628571428571426
George_Dantzig	wikicat_American_operations_researchers	3	107	-104	-34.666666666666664
Lambda_Literary_Award	wikicat_American_literary_awards	2	75	-73	-36.5
Paul_Robinson_(footballer,_born_1984)	wikicat_People_from_Newcastle_upon_Tyne	1	38	-37	-37.0
Helsingborg_Municipality	wordnet_administrative_district_108491826	1	43	-42	-42.0
Marie_Curie	wikicat_Exhumed_people	1	45	-44	-44.0
FC_Baník_Horná_Nitra	wikicat_Defunct_association_football_clubs	37	1667	-1630	-44.054054054054056
Fredericton	wordnet_administrative_district_108491826	27	1237	-1210	-44.81481481481482
John_Magnier	wordnet_person_100007846	4	194	-190	-47.5
Amica_Wronki	wordnet_club_108227214	1	49	-48	-48.0
Club_Atlético_Lanús	wordnet_club_108227214	12	662	-650	-54.166666666666664
Bajo_Aragón	wordnet_administrative_district_108491826	52	2976	-2924	-56.23076923076923
Jaipur	wikicat_Planned_cities	27	1591	-1564	-57.925925925925924
Robert_I,_Duke_of_Parma	wordnet_officeholder_110371450	18	1064	-1046	-58.111111111111114
W._S._Van_Dyke	wikicat_People_from_San_Diego,_California	4	243	-239	-59.75
Inglewood,_California	wordnet_administrative_district_108491826	1	61	-60	-60.0
Jerry_Siegel	wordnet_person_100007846	1	63	-62	-62.0
C.F._Os_Belenenses	wikicat_Association_football_clubs_established_in_1919	18	1166	-1148	-63.77777777777778
Épinal	wikicat_Prefectures_in_France	1	65	-64	-64.0
Zacatepec	wikicat_Association_football_clubs_established_in_1948	20	1327	-1307	-65.35
FC_Meyrin	wikicat_Football_clubs_in_Switzerland	145	9672	-9527	-65.70344827586207
Connacht	wordnet_administrative_district_108491826	3	204	-201	-67.0
Dijon_FCO	wikicat_Association_football_clubs_established_in_1936	5	352	-347	-69.4
Faraday_Medal	wikicat_British_awards	5	355	-350	-70.0
Yaroslav_Svorak	wikicat_Living_people	3	219	-216	-72.0
Philosophy_of_language	wikicat_Branches_of_philosophy	67	4973	-4906	-73.22388059701493
Mamadou_Bagayoko	wikicat_French_people_of_Malian_descent	10	773	-763	-76.3
Chris_de_Burgh	wikicat_Irish_male_singers	3	233	-230	-76.66666666666667
Perth,_Scotland	wikicat_Port_cities_and_towns_of_the_North_Sea	15	1227	-1212	-80.8
Kangerlussuaq_Airport	wordnet_airport_102692232	1	83	-82	-82.0
Portland_Pride	wordnet_club_108227214	2	170	-168	-84.0
Daniel_Pendín	wikicat_People_from_Rosario,_Santa_Fe	3	285	-282	-94.0
Íþróttabandalag_Vestmannaeyja	wikicat_Association_football_clubs_established_in_1903	9	882	-873	-97.0
Papeete	wordnet_administrative_district_108491826	3	308	-305	-101.66666666666667
Robert_Fogel	wikicat_American_historians	1	115	-114	-114.0
Order_of_the_Nile	wikicat_Orders_of_knighthood_awarded_to_heads_of_state,_consorts_and_sovereign_family_members	1	118	-117	-117.0
Bolzano	wordnet_administrative_district_108491826	5	689	-684	-136.8
Canonsburg,_Pennsylvania	wikicat_Boroughs_in_Pennsylvania	7	1096	-1089	-155.57142857142858
Don_Hutchison	wikicat_People_from_Gateshead	1	299	-298	-298.0
Nobel_Prize_in_Chemistry	wikicat_Swedish_awards	3	1367	-1364	-454.6666666666667
S.V._Zulte_Waregem	wikicat_Football_clubs_in_Belgium	2	923	-921	-460.5
Canonsburg,_Pennsylvania	wikicat_Cities_in_Pennsylvania	1	505	-504	-504.0
Umeå	wordnet_administrative_district_108491826	1	1032	-1031	-1031.0
Trabzonspor	wikicat_Football_clubs_in_Turkey	3	4933	-4930	-1643.3333333333333
